UTD;ZONA;TURMA;CARTEIRA;DATA_PEDIDO;NOTAS_ESPERADAS_ATENA;NOTAS_GERADAS_TAB4;DEFASAGEM_GERACAO;DIA_SEMANA;FLAG_DEF
VITORIA DA CONQUISTA;508;EPS;CORTE;2022-08-15;15;14;1;2;N
PIRAJA;350;STC;CORTE;2022-08-19;17;17;0;6;N
BOM JESUS DA LAPA;33;EPS;RECORTE;2022-08-17;6;6;0;4;N
GRACA;137;EPS;CORTE;2022-08-16;63;52;11;3;N
SENHOR DO BONFIM;447;STC;CORTE;2022-08-02;12;11;1;3;N
SERRINHA;458;EPS;CORTE;2022-08-15;20;20;0;2;N
IBOTIRAMA;163;EPS;CORTE;2022-08-19;7;7;0;6;N
CONCEICAO DO COITE;62;STC;CORTE;2022-08-18;11;11;0;5;N
ILHEUS;173;EPS;CORTE;2022-08-05;20;18;2;6;N
EUNAPOLIS;87;EPS;RECORTE;2022-08-17;3;2;1;4;N
BOM JESUS DA LAPA;29;EPS;CORTE;2022-08-15;5;5;0;2;N
LUIS EDUARDO MAGALHAES;313;EPS;CORTE;2022-08-19;6;6;0;6;N
PAULO AFONSO;332;STC;CORTE;2022-08-15;11;11;0;2;N
SENHOR DO BONFIM;446;STC;CORTE;2022-08-12;15;15;0;6;S
ITABUNA;184;EPS;RECORTE;2022-08-10;21;20;1;4;N
CANDEIAS;58;EPS;DISJUNTOR;2022-08-17;16;16;0;4;N
SENHOR DO BONFIM;445;EPS;CORTE;2022-08-12;5;5;0;6;N
PORTO SEGURO;371;EPS;CORTE;2022-08-04;8;8;0;5;N
ITABUNA;232;STC;CORTE;2022-08-11;16;16;0;5;N
JACOBINA;257;EPS;RECORTE;2022-08-04;9;9;0;5;N
JUAZEIRO;288;EPS;CORTE;2022-08-09;15;15;0;3;N
CONCEICAO DO COITE;76;EPS;CORTE;2022-08-08;10;10;0;2;N
GRACA;130;EPS;BAIXA;2022-08-25;21;17;4;5;S
JUAZEIRO;292;EPS;RECORTE;2022-08-11;8;8;0;5;N
GUANAMBI;146;EPS;CORTE;2022-08-11;7;7;0;5;N
ITABERABA;219;EPS;CORTE;2022-08-16;4;3;1;3;N
ITAPETINGA;247;STC;CORTE;2022-08-15;9;9;0;2;N
LAURO DE FREITAS;296;STC;CORTE;2022-08-25;15;15;0;5;S
RIBEIRA DO POMBAL;405;EPS;CORTE;2022-08-24;9;6;3;4;N
SERRINHA;459;EPS;CORTE;2022-08-03;5;5;0;4;N
IRECE;204;EPS;CORTE;2022-08-09;14;14;0;3;N
LIVRAMENTO DE NOSSA SENHORA;308;STC;CORTE;2022-08-05;9;0;9;6;N
BOM JESUS DA LAPA;31;STC;CORTE;2022-08-05;11;0;11;6;N
VITORIA DA CONQUISTA;510;STC;CORTE;2022-08-05;11;0;11;6;N
PIRAJA;350;EPS;CORTE;2022-08-05;17;0;17;6;N
POSTO DA MATA;388;EPS;RECORTE;2022-08-17;6;5;1;4;N
JUAZEIRO;289;STC;CORTE;2022-08-11;1;1;0;5;N
REMANSO;392;STC;RECORTE;2022-08-25;15;13;2;5;N
CAMACARI;53;EPS;CORTE;2022-08-24;19;18;1;4;N
VALENCA;491;EPS;CORTE;2022-08-19;14;14;0;6;N
JACOBINA;263;STC;CORTE;2022-08-19;16;16;0;6;N
SANTO AMARO;421;EPS;RECORTE;2022-08-03;18;17;1;4;N
ALAGOINHAS;3;EPS;RECORTE;2022-08-03;15;14;1;4;N
LAURO DE FREITAS;295;EPS;DISJUNTOR;2022-08-08;20;20;0;2;N
SERRINHA;456;STC;CORTE;2022-08-04;11;11;0;5;N
ITABUNA;184;EPS;BAIXA;2022-08-10;3;3;0;4;N
ILHEUS;183;EPS;CORTE;2022-08-08;20;20;0;2;N
VITORIA DA CONQUISTA;513;EPS;BAIXA;2022-08-05;17;16;1;6;N
ESPLANADA;80;STC;CORTE;2022-08-12;11;11;0;6;N
SERRINHA;459;EPS;RECORTE;2022-08-04;7;7;0;5;N
ESPLANADA;78;EPS;CORTE;2022-08-22;14;13;1;2;N
ITABERABA;215;EPS;CORTE;2022-08-15;4;4;0;2;N
ITAPOAN;254;EPS;CORTE;2022-08-09;24;23;1;3;N
RIBEIRA DO POMBAL;405;EPS;RECORTE;2022-08-25;9;7;2;5;N
JUAZEIRO;284;EPS;CORTE;2022-08-08;20;19;1;2;N
PIRAJA;351;STC;RECORTE;2022-08-08;17;15;2;2;N
CAMACARI;55;STC;CORTE;2022-08-12;15;15;0;6;S
ITABUNA;227;STC;CORTE;2022-08-22;16;16;0;2;N
JUAZEIRO;284;STC;CORTE;2022-08-22;9;9;0;2;N
JEQUIE;281;STC;CORTE;2022-08-02;11;11;0;3;N
SANTO ANTONIO DE JESUS;426;EPS;BAIXA;2022-08-11;15;15;0;5;N
BOM JESUS DA LAPA;33;EPS;BAIXA;2022-08-17;5;5;0;4;N
REMANSO;392;EPS;BAIXA;2022-08-11;12;7;5;5;N
JACOBINA;257;EPS;BAIXA;2022-08-04;5;4;1;5;N
JACOBINA;262;EPS;CORTE;2022-08-17;8;8;0;4;N
BOM JESUS DA LAPA;23;STC;RECORTE;2022-08-03;6;2;4;4;S
ALAGOINHAS;4;STC;RECORTE;2022-08-03;4;3;1;4;S
LUIS EDUARDO MAGALHAES;323;EPS;CORTE;2022-08-22;7;6;1;2;N
BARREIRAS;20;EPS;CORTE;2022-08-11;6;6;0;5;N
PERIPERI;348;EPS;BAIXA;2022-08-25;20;19;1;5;S
PAULO AFONSO;327;STC;CORTE;2022-08-24;15;15;0;4;S
BARREIRAS;20;STC;CORTE;2022-08-25;21;21;0;5;N
JACOBINA;263;EPS;CORTE;2022-08-05;9;0;9;6;N
JUAZEIRO;288;STC;RECORTE;2022-08-24;1;1;0;4;N
VITORIA DA CONQUISTA;515;STC;CORTE;2022-08-19;11;11;0;6;N
PIRAJA;355;EPS;CORTE;2022-08-19;42;41;1;6;N
ITAPOAN;252;EPS;DISJUNTOR;2022-08-16;20;20;0;3;N
ILHEUS;180;STC;CORTE;2022-08-09;21;21;0;3;N
LAURO DE FREITAS;294;STC;RECORTE;2022-08-03;16;16;0;4;N
PORTO SEGURO;371;EPS;BAIXA;2022-08-05;12;11;1;6;N
BARREIRAS;15;EPS;CORTE;2022-08-22;7;7;0;2;N
ITAPOAN;254;EPS;RECORTE;2022-08-10;28;26;2;4;N
PAULO AFONSO;328;STC;RECORTE;2022-08-15;11;10;1;2;N
BOM JESUS DA LAPA;28;EPS;CORTE;2022-08-04;7;7;0;5;N
SANTO ANTONIO DE JESUS;426;STC;RECORTE;2022-08-02;16;15;1;3;N
SERRINHA;465;STC;CORTE;2022-08-19;9;9;0;6;N
REMANSO;393;EPS;CORTE;2022-08-23;66;65;1;3;N
PORTO SEGURO;376;EPS;CORTE;2022-08-18;20;19;1;5;N
VALENCA;490;EPS;DISJUNTOR;2022-08-12;32;32;0;6;S
SENHOR DO BONFIM;452;STC;CORTE;2022-08-16;10;10;0;3;N
VALENCA;487;EPS;CORTE;2022-08-18;7;7;0;5;N
JUAZEIRO;284;STC;RECORTE;2022-08-23;16;15;1;3;N
VITORIA DA CONQUISTA;509;EPS;BAIXA;2022-08-04;20;1;19;5;N
PAULO AFONSO;341;EPS;RECORTE;2022-08-17;18;17;1;4;N
TEIXEIRA DE FREITAS;484;EPS;CORTE;2022-08-17;10;10;0;4;N
IRECE;210;EPS;CORTE;2022-08-11;13;13;0;5;N
GUANAMBI;138;STC;CORTE;2022-08-23;18;17;1;3;N
IBOTIRAMA;171;STC;CORTE;2022-08-11;9;9;0;5;N
LIVRAMENTO DE NOSSA SENHORA;303;STC;RECORTE;2022-08-17;5;5;0;4;N
GUANAMBI;138;EPS;CORTE;2022-08-09;6;6;0;3;N
CAMACARI;55;STC;RECORTE;2022-08-15;16;16;0;2;N
IBOTIRAMA;170;EPS;CORTE;2022-08-09;5;5;0;3;N
CAMACARI;50;STC;CORTE;2022-08-25;16;15;1;5;N
SANTA MARIA DA VITORIA;415;EPS;CORTE;2022-08-08;7;7;0;2;N
IPIAU;188;EPS;CORTE;2022-08-09;8;6;2;3;N
TEIXEIRA DE FREITAS;485;EPS;CORTE;2022-08-05;13;0;13;6;N
ALAGOINHAS;4;EPS;CORTE;2022-08-15;20;19;1;2;N
FEIRA DE SANTANA NORTE;107;EPS;CORTE;2022-08-19;35;33;2;6;N
ITAPETINGA;241;STC;CORTE;2022-08-15;9;9;0;2;N
VITORIA DA CONQUISTA;503;EPS;CORTE;2022-08-03;11;11;0;4;N
JUAZEIRO;291;STC;CORTE;2022-08-12;9;9;0;6;N
SANTO AMARO;422;EPS;CORTE;2022-08-15;22;21;1;2;N
GRACA;131;EPS;CORTE;2022-08-16;21;21;0;3;N
SANTO ANTONIO DE JESUS;435;EPS;RECORTE;2022-08-03;8;7;1;4;N
PITUBA;357;EPS;CORTE;2022-08-16;19;19;0;3;N
SANTA MARIA DA VITORIA;412;STC;CORTE;2022-08-09;11;11;0;3;N
SENHOR DO BONFIM;448;STC;CORTE;2022-08-15;13;12;1;2;N
IRECE;207;STC;CORTE;2022-08-12;11;11;0;6;N
PORTO SEGURO;373;STC;CORTE;2022-08-19;21;21;0;6;N
SANTO ANTONIO DE JESUS;8;STC;CORTE;2022-08-15;13;13;0;2;N
BOM JESUS DA LAPA;23;EPS;CORTE;2022-08-15;10;10;0;2;N
RIBEIRA DO POMBAL;400;EPS;CORTE;2022-08-12;10;10;0;6;N
GRACA;132;EPS;CORTE;2022-08-04;11;10;1;5;N
FEIRA DE SANTANA SUL;121;EPS;CORTE;2022-08-12;16;13;3;6;N
IRECE;205;EPS;CORTE;2022-08-22;8;8;0;2;N
ITABUNA;225;EPS;CORTE;2022-08-09;18;18;0;3;N
VALENCA;498;STC;CORTE;2022-08-23;21;21;0;3;N
ESPLANADA;79;EPS;BAIXA;2022-08-11;18;11;7;5;N
ITAPOAN;254;EPS;BAIXA;2022-08-10;2;1;1;4;N
ITAPETINGA;245;STC;RECORTE;2022-08-17;13;11;2;4;N
IRECE;211;STC;RECORTE;2022-08-12;15;8;7;6;S
GUANAMBI;148;EPS;CORTE;2022-08-12;7;7;0;6;N
EUNAPOLIS;88;EPS;DISJUNTOR;2022-08-12;5;4;1;6;N
GUANAMBI;138;STC;RECORTE;2022-08-24;15;15;0;4;N
TEIXEIRA DE FREITAS;471;STC;RECORTE;2022-08-16;17;17;0;3;N
ITAPOAN;251;STC;RECORTE;2022-08-09;12;4;8;3;S
ITABUNA;230;STC;RECORTE;2022-08-11;18;4;14;5;S
RIBEIRA DO POMBAL;399;EPS;CORTE;2022-08-24;9;8;1;4;N
LUIS EDUARDO MAGALHAES;322;EPS;CORTE;2022-08-11;7;7;0;5;N
FEIRA DE SANTANA SUL;123;STC;CORTE;2022-08-02;1;1;0;3;N
BOM JESUS DA LAPA;27;EPS;RECORTE;2022-08-17;1;1;0;4;N
SANTO AMARO;424;STC;CORTE;2022-08-05;9;0;9;6;N
LUIS EDUARDO MAGALHAES;317;EPS;CORTE;2022-08-22;7;7;0;2;N
BRUMADO;48;STC;CORTE;2022-08-22;11;11;0;2;N
CAMACARI;50;STC;CORTE;2022-08-02;16;16;0;3;N
JEQUIE;275;STC;CORTE;2022-08-02;11;11;0;3;N
BARREIRAS;16;EPS;BAIXA;2022-08-11;10;10;0;5;N
VITORIA DA CONQUISTA;499;STC;CORTE;2022-08-16;11;11;0;3;N
VITORIA DA CONQUISTA;500;STC;CORTE;2022-08-04;11;11;0;5;N
PITUBA;357;EPS;RECORTE;2022-08-17;26;25;1;4;N
VITORIA DA CONQUISTA;503;EPS;RECORTE;2022-08-04;16;15;1;5;N
SANTO ANTONIO DE JESUS;428;STC;CORTE;2022-08-02;19;18;1;3;N
PERIPERI;349;EPS;CORTE;2022-08-16;13;13;0;3;N
REMANSO;392;STC;CORTE;2022-08-24;27;27;0;4;S
ALAGOINHAS;1;STC;CORTE;2022-08-16;4;4;0;3;N
REMANSO;394;STC;CORTE;2022-08-02;9;9;0;3;N
LUIS EDUARDO MAGALHAES;319;STC;CORTE;2022-08-12;11;11;0;6;N
IRECE;202;STC;CORTE;2022-08-23;17;16;1;3;N
ILHEUS;186;STC;CORTE;2022-08-11;16;15;1;5;N
CONCEICAO DO COITE;65;EPS;CORTE;2022-08-19;6;6;0;6;N
ALAGOINHAS;2;STC;CORTE;2022-08-04;11;11;0;5;N
VALENCA;497;EPS;DISJUNTOR;2022-08-04;2;2;0;5;N
VALENCA;494;STC;CORTE;2022-08-22;11;11;0;2;N
GRACA;129;STC;CORTE;2022-08-03;7;7;0;4;S
PORTO SEGURO;369;STC;CORTE;2022-08-18;11;11;0;5;N
SANTO ANTONIO DE JESUS;426;EPS;CORTE;2022-08-12;5;5;0;6;N
RIBEIRA DO POMBAL;400;EPS;RECORTE;2022-08-11;7;4;3;5;S
POSTO DA MATA;387;STC;RECORTE;2022-08-19;18;16;2;6;N
EUNAPOLIS;97;STC;CORTE;2022-08-09;21;18;3;3;N
ITAPETINGA;242;STC;RECORTE;2022-08-04;13;8;5;5;N
ITABUNA;225;EPS;RECORTE;2022-08-10;7;5;2;4;N
JACOBINA;256;EPS;CORTE;2022-08-17;8;7;1;4;N
ESPLANADA;81;STC;CORTE;2022-08-25;11;11;0;5;N
CANDEIAS;59;EPS;CORTE;2022-08-24;17;15;2;4;N
BOM JESUS DA LAPA;33;EPS;CORTE;2022-08-18;5;4;1;5;N
JACOBINA;257;EPS;CORTE;2022-08-05;9;0;9;6;N
JUAZEIRO;290;STC;RECORTE;2022-08-25;16;14;2;5;N
BOM JESUS DA LAPA;30;STC;CORTE;2022-08-19;14;14;0;6;N
PERIPERI;347;EPS;DISJUNTOR;2022-08-23;28;25;3;3;N
FEIRA DE SANTANA NORTE;115;STC;CORTE;2022-08-11;15;14;1;5;N
ITABUNA;235;EPS;RECORTE;2022-08-11;12;3;9;5;S
SENHOR DO BONFIM;446;EPS;CORTE;2022-08-02;16;15;1;3;N
ITAPOAN;252;STC;CORTE;2022-08-23;123;114;9;3;N
SANTA MARIA DA VITORIA;417;STC;CORTE;2022-08-23;16;15;1;3;N
LAURO DE FREITAS;296;EPS;CORTE;2022-08-15;16;15;1;2;N
JEQUIE;269;EPS;CORTE;2022-08-11;21;17;4;5;N
JACOBINA;256;EPS;RECORTE;2022-08-18;9;9;0;5;N
EUNAPOLIS;85;EPS;BAIXA;2022-08-17;4;3;1;4;N
SENHOR DO BONFIM;447;STC;CORTE;2022-08-04;13;13;0;5;N
SERRINHA;458;EPS;CORTE;2022-08-17;14;14;0;4;N
GRACA;137;EPS;CORTE;2022-08-18;21;15;6;5;N
RIBEIRA DO POMBAL;408;STC;CORTE;2022-08-04;11;11;0;5;N
VALENCA;494;STC;RECORTE;2022-08-23;11;10;1;3;N
REMANSO;391;EPS;RECORTE;2022-08-25;20;20;0;5;N
CANDEIAS;59;EPS;RECORTE;2022-08-25;14;7;7;5;N
RIBEIRA DO POMBAL;398;STC;RECORTE;2022-08-02;11;11;0;3;N
ITABUNA;225;EPS;BAIXA;2022-08-10;3;3;0;4;N
ALAGOINHAS;1;STC;RECORTE;2022-08-17;53;28;25;4;N
ILHEUS;178;STC;RECORTE;2022-08-09;8;3;5;3;S
ITAPETINGA;247;EPS;CORTE;2022-08-03;9;9;0;4;N
ITABUNA;231;STC;CORTE;2022-08-25;21;19;2;5;N
BRUMADO;44;STC;CORTE;2022-08-19;10;10;0;6;S
ITABUNA;230;EPS;CORTE;2022-08-23;23;23;0;3;N
EUNAPOLIS;105;EPS;CORTE;2022-08-22;11;11;0;2;N
CANDEIAS;58;EPS;DISJUNTOR;2022-08-19;10;10;0;6;N
BRUMADO;45;STC;CORTE;2022-08-09;11;11;0;3;N
PAULO AFONSO;336;EPS;RECORTE;2022-08-05;1;1;0;6;N
PERIPERI;347;STC;CORTE;2022-08-03;4;4;0;4;S
PERIPERI;347;STC;CORTE;2022-08-05;16;0;16;6;N
LAURO DE FREITAS;298;STC;CORTE;2022-08-05;16;0;16;6;N
ITAPETINGA;248;STC;CORTE;2022-08-05;9;0;9;6;N
POSTO DA MATA;385;EPS;CORTE;2022-08-05;18;0;18;6;N
SERRINHA;459;EPS;CORTE;2022-08-05;8;0;8;6;N
LAURO DE FREITAS;293;EPS;CORTE;2022-08-02;15;14;1;3;N
SANTO ANTONIO DE JESUS;433;STC;CORTE;2022-08-16;19;18;1;3;N
ILHEUS;183;EPS;CORTE;2022-08-10;20;20;0;4;N
JUAZEIRO;290;STC;RECORTE;2022-08-02;16;8;8;3;N
LAURO DE FREITAS;294;EPS;DISJUNTOR;2022-08-22;17;16;1;2;N
VITORIA DA CONQUISTA;505;STC;CORTE;2022-08-18;11;11;0;5;N
CONCEICAO DO COITE;72;STC;CORTE;2022-08-23;10;10;0;3;N
JACOBINA;256;EPS;BAIXA;2022-08-18;4;4;0;5;N
JEQUIE;266;STC;CORTE;2022-08-12;6;5;1;6;N
SERRINHA;458;EPS;RECORTE;2022-08-18;7;7;0;5;N
LAURO DE FREITAS;293;STC;CORTE;2022-08-16;16;16;0;3;N
JACOBINA;264;STC;CORTE;2022-08-09;15;14;1;3;N
GUANAMBI;142;EPS;CORTE;2022-08-12;7;7;0;6;N
ITABERABA;216;STC;CORTE;2022-08-19;14;14;0;6;N
FEIRA DE SANTANA NORTE;110;EPS;CORTE;2022-08-08;27;26;1;2;N
SENHOR DO BONFIM;446;EPS;RECORTE;2022-08-03;7;6;1;4;N
IRECE;200;STC;CORTE;2022-08-22;3;3;0;2;S
POSTO DA MATA;381;EPS;CORTE;2022-08-04;7;5;2;5;N
PAULO AFONSO;328;EPS;CORTE;2022-08-02;10;10;0;3;N
JUAZEIRO;284;EPS;CORTE;2022-08-10;15;15;0;4;N
ITAPETINGA;243;STC;CORTE;2022-08-16;11;10;1;3;N
ITABUNA;230;EPS;RECORTE;2022-08-24;11;11;0;4;N
VITORIA DA CONQUISTA;508;EPS;RECORTE;2022-08-18;16;15;1;5;N
ITABUNA;226;EPS;CORTE;2022-08-22;16;15;1;2;N
IBOTIRAMA;160;EPS;CORTE;2022-08-08;7;7;0;2;N
VALENCA;492;EPS;CORTE;2022-08-09;16;16;0;3;N
CONCEICAO DO COITE;76;EPS;RECORTE;2022-08-11;5;4;1;5;N
LAURO DE FREITAS;298;STC;RECORTE;2022-08-04;12;4;8;5;S
JACOBINA;262;EPS;CORTE;2022-08-19;8;8;0;6;N
LAURO DE FREITAS;297;STC;RECORTE;2022-08-18;16;13;3;5;N
LIVRAMENTO DE NOSSA SENHORA;308;STC;RECORTE;2022-08-08;3;3;0;2;N
CONCEICAO DO COITE;72;EPS;CORTE;2022-08-09;7;7;0;3;N
FEIRA DE SANTANA NORTE;115;STC;RECORTE;2022-08-12;1;1;0;6;N
VALENCA;495;EPS;DISJUNTOR;2022-08-05;1;0;1;6;N
ITABERABA;216;EPS;CORTE;2022-08-05;6;0;6;6;N
JUAZEIRO;0;STC;CORTE;2022-08-23;1;1;0;3;N
BRUMADO;42;EPS;CORTE;2022-08-08;7;6;1;2;N
IRECE;196;STC;CORTE;2022-08-23;21;21;0;3;N
VALENCA;490;EPS;DISJUNTOR;2022-08-16;15;14;1;3;N
FEIRA DE SANTANA SUL;125;EPS;CORTE;2022-08-15;18;18;0;2;N
VITORIA DA CONQUISTA;519;STC;RECORTE;2022-08-23;11;10;1;3;N
SENHOR DO BONFIM;452;EPS;CORTE;2022-08-04;14;14;0;5;N
VITORIA DA CONQUISTA;518;EPS;DISJUNTOR;2022-08-03;16;16;0;4;N
PAULO AFONSO;324;STC;CORTE;2022-08-15;11;11;0;2;N
IRECE;197;STC;CORTE;2022-08-11;11;11;0;5;N
ITAPOAN;251;STC;CORTE;2022-08-12;19;19;0;6;N
BARREIRAS;18;STC;CORTE;2022-08-02;15;15;0;3;N
GUANAMBI;138;EPS;CORTE;2022-08-11;7;7;0;5;N
JUAZEIRO;284;EPS;RECORTE;2022-08-11;8;8;0;5;N
ITABUNA;230;EPS;BAIXA;2022-08-24;2;1;1;4;N
FEIRA DE SANTANA NORTE;120;EPS;CORTE;2022-08-11;11;11;0;5;N
IBOTIRAMA;157;STC;CORTE;2022-08-09;8;8;0;3;N
JACOBINA;264;STC;RECORTE;2022-08-10;2;2;0;4;N
LUIS EDUARDO MAGALHAES;320;STC;CORTE;2022-08-25;9;8;1;5;N
GUANAMBI;138;STC;CORTE;2022-08-25;17;16;1;5;N
IBOTIRAMA;155;EPS;CORTE;2022-08-19;14;14;0;6;N
SERRINHA;464;EPS;CORTE;2022-08-19;7;7;0;6;N
ILHEUS;179;EPS;CORTE;2022-08-09;14;14;0;3;N
PORTO SEGURO;377;EPS;CORTE;2022-08-08;11;10;1;2;N
IPIAU;188;EPS;CORTE;2022-08-11;8;6;2;5;N
IRECE;196;EPS;CORTE;2022-08-09;12;11;1;3;N
TEIXEIRA DE FREITAS;472;STC;CORTE;2022-08-05;15;0;15;6;N
SEABRA;442;STC;CORTE;2022-08-05;7;0;7;6;N
FEIRA DE SANTANA SUL;127;STC;CORTE;2022-08-05;1;0;1;6;N
SEABRA;444;EPS;RECORTE;2022-08-17;3;0;3;4;N
JUAZEIRO;289;EPS;CORTE;2022-08-24;16;15;1;4;N
PIRAJA;354;EPS;DISJUNTOR;2022-08-16;17;15;2;3;N
JUAZEIRO;290;EPS;CORTE;2022-08-12;30;30;0;6;N
SENHOR DO BONFIM;451;EPS;RECORTE;2022-08-17;11;11;0;4;N
FEIRA DE SANTANA SUL;126;EPS;RECORTE;2022-08-04;14;13;1;5;N
AMARGOSA;11;STC;CORTE;2022-08-08;18;18;0;2;N
PORTO SEGURO;374;STC;CORTE;2022-08-09;21;20;1;3;N
JUAZEIRO;292;STC;CORTE;2022-08-02;9;9;0;3;N
ILHEUS;178;EPS;DISJUNTOR;2022-08-04;23;23;0;5;N
FEIRA DE SANTANA SUL;122;EPS;CORTE;2022-08-02;18;18;0;3;N
ITABUNA;225;EPS;CORTE;2022-08-11;13;13;0;5;N
PITUBA;357;EPS;CORTE;2022-08-18;18;17;1;5;N
PERIPERI;348;STC;CORTE;2022-08-18;16;15;1;5;N
VITORIA DA CONQUISTA;502;EPS;CORTE;2022-08-17;30;28;2;4;N
FEIRA DE SANTANA NORTE;108;EPS;CORTE;2022-08-09;140;133;7;3;N
SENHOR DO BONFIM;447;EPS;CORTE;2022-08-15;6;6;0;2;N
PIRAJA;352;STC;CORTE;2022-08-22;17;17;0;2;N
SANTA MARIA DA VITORIA;411;STC;CORTE;2022-08-23;7;7;0;3;N
FEIRA DE SANTANA SUL;122;STC;CORTE;2022-08-16;1;1;0;3;N
ILHEUS;179;EPS;RECORTE;2022-08-10;7;6;1;4;N
SEABRA;437;EPS;CORTE;2022-08-02;6;6;0;3;N
ILHEUS;183;EPS;BAIXA;2022-08-11;18;18;0;5;N
IRECE;210;EPS;RECORTE;2022-08-12;9;6;3;6;S
CAMACARI;53;EPS;BAIXA;2022-08-25;11;7;4;5;S
PITUBA;359;STC;CORTE;2022-08-08;19;19;0;2;N
LAURO DE FREITAS;298;EPS;CORTE;2022-08-16;16;13;3;3;N
ILHEUS;179;STC;RECORTE;2022-08-22;7;4;3;2;S
RIBEIRA DO POMBAL;405;EPS;RECORTE;2022-08-04;7;6;1;5;N
ITAPETINGA;241;EPS;CORTE;2022-08-03;9;9;0;4;N
VALENCA;497;EPS;CORTE;2022-08-23;11;11;0;3;N
ILHEUS;178;STC;DISJUNTOR;2022-08-16;10;10;0;3;S
ITAPETINGA;242;STC;CORTE;2022-08-05;9;0;9;6;N
SANTO ANTONIO DE JESUS;9;STC;CORTE;2022-08-05;13;0;13;6;N
FEIRA DE SANTANA SUL;123;STC;CORTE;2022-08-04;2;2;0;5;N
LIVRAMENTO DE NOSSA SENHORA;301;EPS;CORTE;2022-08-05;4;0;4;6;N
VITORIA DA CONQUISTA;518;EPS;BAIXA;2022-08-19;16;0;16;6;S
LUIS EDUARDO MAGALHAES;320;STC;CORTE;2022-08-02;11;11;0;3;N
RIBEIRA DO POMBAL;400;EPS;RECORTE;2022-08-15;6;6;0;2;N
LUIS EDUARDO MAGALHAES;318;EPS;CORTE;2022-08-12;7;6;1;6;N
VITORIA DA CONQUISTA;499;STC;CORTE;2022-08-18;11;10;1;5;N
BRUMADO;49;STC;CORTE;2022-08-12;11;11;0;6;N
AMARGOSA;6;STC;CORTE;2022-08-19;18;17;1;6;N
CAMACARI;50;STC;CORTE;2022-08-02;20;20;0;3;S
ITAPETINGA;237;STC;CORTE;2022-08-16;9;9;0;3;N
ALAGOINHAS;1;EPS;CORTE;2022-08-04;36;35;1;5;N
ITAPETINGA;237;EPS;CORTE;2022-08-02;11;8;3;3;N
ALAGOINHAS;1;STC;CORTE;2022-08-18;19;19;0;5;N
EUNAPOLIS;97;STC;CORTE;2022-08-11;21;20;1;5;N
VALENCA;495;STC;CORTE;2022-08-12;17;17;0;6;N
REMANSO;393;EPS;CORTE;2022-08-02;30;30;0;3;N
AMARGOSA;11;STC;RECORTE;2022-08-09;18;12;6;3;N
FEIRA DE SANTANA SUL;122;STC;RECORTE;2022-08-17;21;10;11;4;N
SANTO ANTONIO DE JESUS;427;EPS;CORTE;2022-08-02;6;4;2;3;N
VALENCA;497;EPS;RECORTE;2022-08-24;13;9;4;4;N
JUAZEIRO;289;EPS;RECORTE;2022-08-25;11;10;1;5;N
TEIXEIRA DE FREITAS;482;STC;RECORTE;2022-08-09;17;3;14;3;N
GRACA;133;STC;RECORTE;2022-08-09;17;5;12;3;N
ILHEUS;179;EPS;BAIXA;2022-08-10;5;4;1;4;N
VALENCA;493;EPS;CORTE;2022-08-22;8;8;0;2;N
SEABRA;441;EPS;BAIXA;2022-08-04;22;22;0;5;N
ITAPOAN;250;EPS;BAIXA;2022-08-11;15;15;0;5;N
PITUBA;359;STC;RECORTE;2022-08-09;21;7;14;3;N
SANTO AMARO;424;STC;RECORTE;2022-08-08;13;12;1;2;N
GRACA;132;STC;RECORTE;2022-08-19;11;1;10;6;S
SANTO AMARO;421;EPS;DISJUNTOR;2022-08-12;6;5;1;6;N
IRECE;202;STC;CORTE;2022-08-25;7;7;0;5;N
JUAZEIRO;286;STC;CORTE;2022-08-25;9;8;1;5;N
JACOBINA;534;EPS;CORTE;2022-08-17;7;7;0;4;N
CONCEICAO DO COITE;66;EPS;CORTE;2022-08-09;7;6;1;3;N
ESPLANADA;80;EPS;CORTE;2022-08-25;12;0;12;5;N
PIRAJA;350;EPS;CORTE;2022-08-09;17;16;1;3;N
IPIAU;526;EPS;CORTE;2022-08-02;11;11;0;3;N
RIBEIRA DO POMBAL;410;EPS;RECORTE;2022-08-18;10;10;0;5;N
SENHOR DO BONFIM;446;EPS;CORTE;2022-08-04;13;13;0;5;N
ITABUNA;232;STC;CORTE;2022-08-15;32;32;0;2;N
VALENCA;490;STC;CORTE;2022-08-23;17;17;0;3;N
SEABRA;443;STC;CORTE;2022-08-18;21;21;0;5;N
SANTO ANTONIO DE JESUS;427;EPS;RECORTE;2022-08-03;8;8;0;4;N
SERRINHA;458;EPS;CORTE;2022-08-19;14;14;0;6;N
BOM JESUS DA LAPA;29;EPS;CORTE;2022-08-19;5;5;0;6;N
IPIAU;526;STC;CORTE;2022-08-16;13;13;0;3;N
PAULO AFONSO;334;EPS;BAIXA;2022-08-05;15;15;0;6;N
LIVRAMENTO DE NOSSA SENHORA;306;EPS;CORTE;2022-08-19;5;5;0;6;N
ITABERABA;220;EPS;CORTE;2022-08-08;6;6;0;2;N
REMANSO;393;EPS;RECORTE;2022-08-03;8;4;4;4;N
VITORIA DA CONQUISTA;513;STC;RECORTE;2022-08-23;17;17;0;3;N
BRUMADO;44;EPS;CORTE;2022-08-09;6;5;1;3;N
ITAPOAN;252;STC;CORTE;2022-08-25;19;18;1;5;N
SANTA MARIA DA VITORIA;417;STC;CORTE;2022-08-25;16;15;1;5;N
ILHEUS;173;EPS;CORTE;2022-08-09;7;7;0;3;N
CANDEIAS;59;EPS;DISJUNTOR;2022-08-09;6;4;2;3;N
BOM JESUS DA LAPA;31;STC;CORTE;2022-08-09;11;11;0;3;N
FEIRA DE SANTANA SUL;128;STC;CORTE;2022-08-18;1;1;0;5;N
CAMACARI;50;STC;RECORTE;2022-08-05;16;0;16;6;N
PAULO AFONSO;332;EPS;CORTE;2022-08-05;8;0;8;6;N
LAURO DE FREITAS;293;STC;CORTE;2022-08-18;16;16;0;5;N
JACOBINA;263;EPS;CORTE;2022-08-09;9;9;0;3;N
ILHEUS;173;EPS;RECORTE;2022-08-10;7;6;1;4;N
FEIRA DE SANTANA NORTE;109;EPS;CORTE;2022-08-22;32;31;1;2;N
ITABERABA;217;STC;CORTE;2022-08-09;11;11;0;3;N
VALENCA;492;EPS;CORTE;2022-08-11;12;12;0;5;N
SENHOR DO BONFIM;445;EPS;RECORTE;2022-08-17;10;10;0;4;N
CANDEIAS;58;STC;RECORTE;2022-08-02;20;8;12;3;S
GRACA;133;EPS;CORTE;2022-08-19;42;40;2;6;N
JACOBINA;263;STC;CORTE;2022-08-23;16;14;2;3;N
JACOBINA;264;STC;CORTE;2022-08-11;10;9;1;5;N
PAULO AFONSO;328;STC;CORTE;2022-08-18;11;11;0;5;N
LAURO DE FREITAS;293;STC;CORTE;2022-08-16;5;5;0;3;S
LAURO DE FREITAS;296;EPS;RECORTE;2022-08-18;22;13;9;5;N
ITABUNA;230;EPS;RECORTE;2022-08-24;10;10;0;4;S
PAULO AFONSO;328;EPS;CORTE;2022-08-04;8;8;0;5;N
JUAZEIRO;284;EPS;CORTE;2022-08-12;15;14;1;6;N
SERRINHA;468;EPS;CORTE;2022-08-22;6;6;0;2;N
SERRINHA;456;STC;CORTE;2022-08-08;11;11;0;2;N
BOM JESUS DA LAPA;27;STC;CORTE;2022-08-08;5;5;0;2;N
PORTO SEGURO;366;EPS;CORTE;2022-08-19;7;7;0;6;N
TEIXEIRA DE FREITAS;482;EPS;CORTE;2022-08-19;10;9;1;6;N
IBOTIRAMA;161;STC;CORTE;2022-08-12;9;9;0;6;N
BARREIRAS;20;EPS;CORTE;2022-08-15;7;7;0;2;N
ITABUNA;227;EPS;CORTE;2022-08-12;17;17;0;6;N
PERIPERI;347;STC;RECORTE;2022-08-08;19;10;9;2;N
JUAZEIRO;290;STC;RECORTE;2022-08-04;16;16;0;5;N
JUAZEIRO;286;STC;CORTE;2022-08-02;9;9;0;3;N
SANTO ANTONIO DE JESUS;432;EPS;CORTE;2022-08-16;4;4;0;3;N
CONCEICAO DO COITE;72;STC;CORTE;2022-08-25;11;11;0;5;N
ILHEUS;183;EPS;CORTE;2022-08-12;22;21;1;6;N
ILHEUS;173;STC;DISJUNTOR;2022-08-04;20;20;0;5;S
JACOBINA;534;EPS;BAIXA;2022-08-18;1;1;0;5;N
RIBEIRA DO POMBAL;404;STC;CORTE;2022-08-05;11;0;11;6;N
BARREIRAS;22;STC;CORTE;2022-08-05;9;0;9;6;N
LUIS EDUARDO MAGALHAES;321;STC;CORTE;2022-08-15;11;11;0;2;N
VALENCA;487;EPS;CORTE;2022-08-22;30;30;0;2;N
FEIRA DE SANTANA NORTE;107;STC;CORTE;2022-08-11;11;11;0;5;N
CAMACARI;50;EPS;CORTE;2022-08-15;22;21;1;2;N
BARREIRAS;18;STC;CORTE;2022-08-04;15;15;0;5;N
JEQUIE;275;EPS;CORTE;2022-08-15;44;44;0;2;N
IPIAU;189;STC;CORTE;2022-08-15;16;16;0;2;N
ITAPOAN;250;EPS;CORTE;2022-08-12;69;65;4;6;N
JEQUIE;266;STC;RECORTE;2022-08-15;11;8;3;2;N
ESPLANADA;80;EPS;RECORTE;2022-08-03;9;9;0;4;N
SEABRA;442;STC;CORTE;2022-08-05;12;12;0;6;S
ITABERABA;213;STC;CORTE;2022-08-08;11;10;1;2;N
PIRAJA;355;EPS;CORTE;2022-08-23;13;12;1;3;N
IRECE;210;EPS;CORTE;2022-08-15;13;12;1;2;N
FEIRA DE SANTANA SUL;125;EPS;CORTE;2022-08-17;18;18;0;4;N
SERRINHA;465;STC;CORTE;2022-08-23;9;9;0;3;N
VITORIA DA CONQUISTA;519;EPS;RECORTE;2022-08-11;15;15;0;5;N
SENHOR DO BONFIM;451;EPS;CORTE;2022-08-18;10;9;1;5;N
BARREIRAS;17;STC;CORTE;2022-08-16;15;15;0;3;N
IPIAU;532;STC;CORTE;2022-08-18;13;13;0;5;N
SANTO ANTONIO DE JESUS;431;STC;DISJUNTOR;2022-08-23;15;15;0;3;S
VALENCA;491;EPS;RECORTE;2022-08-24;26;24;2;4;N
AMARGOSA;5;STC;RECORTE;2022-08-09;19;11;8;3;N
TEIXEIRA DE FREITAS;470;EPS;CORTE;2022-08-17;10;6;4;4;N
JACOBINA;259;EPS;CORTE;2022-08-08;7;7;0;2;N
REMANSO;394;EPS;CORTE;2022-08-15;11;11;0;2;N
EUNAPOLIS;90;EPS;CORTE;2022-08-09;12;12;0;3;N
REMANSO;393;EPS;CORTE;2022-08-25;25;24;1;5;S
ITABUNA;185;EPS;CORTE;2022-08-24;2;2;0;4;S
IBOTIRAMA;156;EPS;CORTE;2022-08-09;5;3;2;3;N
VITORIA DA CONQUISTA;518;EPS;DISJUNTOR;2022-08-05;26;0;26;6;N
SEABRA;441;EPS;CORTE;2022-08-05;6;0;6;6;N
BRUMADO;44;EPS;BAIXA;2022-08-10;1;0;1;4;N
ITABUNA;227;STC;RECORTE;2022-08-25;18;6;12;5;S
GRACA;137;EPS;BAIXA;2022-08-19;27;0;27;6;S
LUIS EDUARDO MAGALHAES;319;EPS;CORTE;2022-08-25;7;0;7;5;N
BARREIRAS;13;STC;CORTE;2022-08-15;15;15;0;2;N
PIRAJA;351;EPS;CORTE;2022-08-22;13;13;0;2;N
IRECE;207;STC;CORTE;2022-08-16;11;10;1;3;N
AMARGOSA;12;EPS;DISJUNTOR;2022-08-16;3;3;0;3;N
IRECE;193;STC;CORTE;2022-08-12;22;20;2;6;N
PITUBA;358;EPS;CORTE;2022-08-08;27;26;1;2;N
SANTO AMARO;422;EPS;CORTE;2022-08-19;20;20;0;6;N
PORTO SEGURO;373;STC;CORTE;2022-08-23;21;18;3;3;N
IRECE;196;STC;RECORTE;2022-08-24;18;13;5;4;S
POSTO DA MATA;387;STC;CORTE;2022-08-22;13;12;1;2;N
JUAZEIRO;291;EPS;CORTE;2022-08-02;15;15;0;3;N
AMARGOSA;10;EPS;CORTE;2022-08-08;7;7;0;2;N
FEIRA DE SANTANA SUL;121;EPS;CORTE;2022-08-16;18;17;1;3;N
CANDEIAS;59;STC;CORTE;2022-08-16;26;26;0;3;N
JUAZEIRO;292;STC;CORTE;2022-08-04;9;9;0;5;N
GUANAMBI;148;EPS;CORTE;2022-08-16;6;5;1;3;N
FEIRA DE SANTANA SUL;122;STC;CORTE;2022-08-18;24;24;0;5;N
FEIRA DE SANTANA SUL;122;STC;CORTE;2022-08-16;20;20;0;3;S
FEIRA DE SANTANA SUL;125;EPS;RECORTE;2022-08-18;14;14;0;5;N
PAULO AFONSO;338;STC;RECORTE;2022-08-22;8;7;1;2;N
TEIXEIRA DE FREITAS;470;EPS;RECORTE;2022-08-18;8;4;4;5;N
ILHEUS;178;EPS;RECORTE;2022-08-24;8;6;2;4;N
SENHOR DO BONFIM;453;STC;RECORTE;2022-08-09;11;8;3;3;N
VITORIA DA CONQUISTA;518;EPS;BAIXA;2022-08-23;21;16;5;3;N
BRUMADO;39;STC;CORTE;2022-08-11;11;11;0;5;N
IBOTIRAMA;168;STC;CORTE;2022-08-02;9;9;0;3;N
FEIRA DE SANTANA NORTE;115;EPS;CORTE;2022-08-24;3;3;0;4;N
LUIS EDUARDO MAGALHAES;323;EPS;BAIXA;2022-08-25;11;11;0;5;S
GUANAMBI;149;EPS;CORTE;2022-08-04;7;7;0;5;N
POSTO DA MATA;387;EPS;CORTE;2022-08-08;8;8;0;2;N
CAMACARI;51;STC;RECORTE;2022-08-18;16;15;1;5;N
IBOTIRAMA;166;STC;CORTE;2022-08-24;5;5;0;4;S
ITAPOAN;251;STC;RECORTE;2022-08-15;19;15;4;2;N
SENHOR DO BONFIM;449;STC;CORTE;2022-08-05;7;7;0;6;S
ITAPETINGA;241;EPS;CORTE;2022-08-05;14;0;14;6;N
SENHOR DO BONFIM;448;EPS;CORTE;2022-08-05;7;0;7;6;N
SANTO ANTONIO DE JESUS;431;EPS;CORTE;2022-08-05;6;0;6;6;N
SANTO ANTONIO DE JESUS;8;EPS;CORTE;2022-08-05;6;0;6;6;N
ESPLANADA;81;EPS;CORTE;2022-08-15;9;9;0;2;N
LAURO DE FREITAS;295;STC;CORTE;2022-08-19;16;12;4;6;N
PAULO AFONSO;330;STC;CORTE;2022-08-19;16;16;0;6;N
RIBEIRA DO POMBAL;400;EPS;RECORTE;2022-08-17;22;22;0;4;N
IRECE;207;EPS;RECORTE;2022-08-03;6;6;0;4;N
BRUMADO;37;STC;DISJUNTOR;2022-08-16;15;15;0;3;S
TEIXEIRA DE FREITAS;480;EPS;DISJUNTOR;2022-08-03;12;10;2;4;N
PORTO SEGURO;371;EPS;DISJUNTOR;2022-08-16;16;16;0;3;N
AMARGOSA;7;STC;CORTE;2022-08-09;17;15;2;3;N
PORTO SEGURO;377;EPS;BAIXA;2022-08-11;6;4;2;5;N
LUIS EDUARDO MAGALHAES;319;EPS;CORTE;2022-08-02;8;8;0;3;N
LUIS EDUARDO MAGALHAES;320;STC;CORTE;2022-08-04;11;11;0;5;N
SANTO ANTONIO DE JESUS;427;STC;CORTE;2022-08-18;16;16;0;5;N
BARREIRAS;22;EPS;CORTE;2022-08-16;6;5;1;3;N
PAULO AFONSO;345;STC;CORTE;2022-08-11;10;10;0;5;N
AMARGOSA;5;EPS;CORTE;2022-08-19;20;20;0;6;N
VALENCA;494;EPS;CORTE;2022-08-12;7;7;0;6;N
POSTO DA MATA;382;EPS;CORTE;2022-08-19;3;3;0;6;N
PORTO SEGURO;373;EPS;RECORTE;2022-08-10;21;21;0;4;N
FEIRA DE SANTANA SUL;122;EPS;RECORTE;2022-08-05;46;45;1;6;N
JACOBINA;534;EPS;CORTE;2022-08-19;8;6;2;6;N
VITORIA DA CONQUISTA;500;STC;CORTE;2022-08-08;11;11;0;2;N
IRECE;211;EPS;BAIXA;2022-08-04;7;7;0;5;N
CAMACARI;50;EPS;BAIXA;2022-08-16;17;16;1;3;N
FEIRA DE SANTANA SUL;125;EPS;BAIXA;2022-08-18;6;6;0;5;N
IRECE;207;STC;RECORTE;2022-08-17;21;14;7;4;N
IRECE;203;STC;CORTE;2022-08-15;10;7;3;2;N
SANTO AMARO;422;EPS;DISJUNTOR;2022-08-02;2;2;0;3;N
REMANSO;393;EPS;CORTE;2022-08-04;18;18;0;5;N
ITAPETINGA;237;STC;CORTE;2022-08-18;8;7;1;5;N
SANTO ANTONIO DE JESUS;426;EPS;CORTE;2022-08-16;4;4;0;3;N
JACOBINA;264;EPS;CORTE;2022-08-22;2;2;0;2;N
EUNAPOLIS;99;EPS;RECORTE;2022-08-25;3;2;1;5;N
ESPLANADA;83;STC;CORTE;2022-08-05;10;0;10;6;N
ITABERABA;222;STC;RECORTE;2022-08-24;17;16;1;4;N
PIRAJA;352;STC;RECORTE;2022-08-25;17;9;8;5;N
VALENCA;489;EPS;CORTE;2022-08-23;11;11;0;3;N
ESPLANADA;78;STC;CORTE;2022-08-16;11;11;0;3;N
ITAPETINGA;248;STC;CORTE;2022-08-09;9;8;1;3;N
PORTO SEGURO;369;STC;RECORTE;2022-08-23;16;16;0;3;N
GRACA;137;EPS;CORTE;2022-08-22;21;20;1;2;N
ITAPOAN;253;STC;CORTE;2022-08-15;19;19;0;2;N
LUIS EDUARDO MAGALHAES;319;EPS;RECORTE;2022-08-03;5;5;0;4;N
PIRAJA;352;EPS;BAIXA;2022-08-11;20;19;1;5;N
SANTO ANTONIO DE JESUS;426;EPS;RECORTE;2022-08-17;6;6;0;4;N
ITABUNA;233;STC;CORTE;2022-08-03;20;20;0;4;S
ALAGOINHAS;2;STC;RECORTE;2022-08-09;9;6;3;3;N
GUANAMBI;142;EPS;DISJUNTOR;2022-08-22;11;11;0;2;N
SEABRA;444;STC;CORTE;2022-08-08;8;7;1;2;N
IRECE;192;EPS;BAIXA;2022-08-11;14;14;0;5;N
SEABRA;442;EPS;CORTE;2022-08-18;11;11;0;5;N
PERIPERI;347;STC;CORTE;2022-08-09;32;30;2;3;N
SANTO ANTONIO DE JESUS;428;STC;RECORTE;2022-08-05;11;5;6;6;S
ALAGOINHAS;1;STC;RECORTE;2022-08-19;9;6;3;6;S
BOM JESUS DA LAPA;30;EPS;CORTE;2022-08-09;5;5;0;3;N
VITORIA DA CONQUISTA;500;STC;RECORTE;2022-08-09;17;16;1;3;N
BRUMADO;44;STC;CORTE;2022-08-25;11;11;0;5;N
SERRINHA;459;EPS;CORTE;2022-08-09;6;6;0;3;N
IPIAU;526;EPS;CORTE;2022-08-04;10;9;1;5;N
IBOTIRAMA;154;EPS;RECORTE;2022-08-11;6;6;0;5;N
REMANSO;392;EPS;RECORTE;2022-08-17;4;4;0;4;N
VITORIA DA CONQUISTA;509;EPS;CORTE;2022-08-09;15;14;1;3;N
REMANSO;390;STC;CORTE;2022-08-05;9;0;9;6;N
ITABUNA;233;STC;CORTE;2022-08-05;16;0;16;6;N
ITAPOAN;251;EPS;CORTE;2022-08-25;40;0;40;5;N
LUIS EDUARDO MAGALHAES;313;EPS;CORTE;2022-08-25;5;0;5;5;N
JEQUIE;266;EPS;CORTE;2022-08-02;11;10;1;3;N
JACOBINA;262;EPS;CORTE;2022-08-23;8;8;0;3;N
TEIXEIRA DE FREITAS;469;STC;CORTE;2022-08-19;17;16;1;6;N
JUAZEIRO;285;EPS;CORTE;2022-08-02;15;13;2;3;N
JUAZEIRO;286;STC;CORTE;2022-08-04;9;9;0;5;N
GRACA;134;EPS;CORTE;2022-08-09;42;41;1;3;N
ITABERABA;216;STC;CORTE;2022-08-23;15;15;0;3;N
VITORIA DA CONQUISTA;521;STC;CORTE;2022-08-02;11;11;0;3;N
JEQUIE;266;STC;CORTE;2022-08-16;9;8;1;3;N
BOM JESUS DA LAPA;26;STC;CORTE;2022-08-22;14;14;0;2;N
LIVRAMENTO DE NOSSA SENHORA;303;STC;CORTE;2022-08-22;11;11;0;2;N
BRUMADO;41;STC;CORTE;2022-08-12;11;10;1;6;N
CONCEICAO DO COITE;62;EPS;RECORTE;2022-08-11;5;4;1;5;N
JUAZEIRO;289;EPS;RECORTE;2022-08-04;11;10;1;5;N
ITABERABA;217;STC;CORTE;2022-08-11;22;22;0;5;N
PAULO AFONSO;403;STC;CORTE;2022-08-02;11;11;0;3;N
JEQUIE;271;STC;RECORTE;2022-08-04;20;14;6;5;S
ITABUNA;233;STC;RECORTE;2022-08-04;13;8;5;5;S
SERRINHA;455;STC;CORTE;2022-08-22;11;11;0;2;N
POSTO DA MATA;385;EPS;RECORTE;2022-08-10;4;4;0;4;N
SANTO ANTONIO DE JESUS;9;EPS;CORTE;2022-08-18;8;7;1;5;N
ITAPETINGA;242;EPS;CORTE;2022-08-18;10;9;1;5;N
SANTO ANTONIO DE JESUS;432;EPS;CORTE;2022-08-18;4;4;0;5;N
ITABUNA;185;EPS;BAIXA;2022-08-04;5;5;0;5;N
LUIS EDUARDO MAGALHAES;317;EPS;BAIXA;2022-08-25;11;2;9;5;S
CANDEIAS;58;STC;RECORTE;2022-08-04;6;4;2;5;S
SENHOR DO BONFIM;454;STC;RECORTE;2022-08-22;17;16;1;2;N
JUAZEIRO;290;STC;RECORTE;2022-08-04;7;4;3;5;S
SERRINHA;459;STC;RECORTE;2022-08-22;6;4;2;2;S
FEIRA DE SANTANA NORTE;109;EPS;CORTE;2022-08-24;30;27;3;4;N
BARREIRAS;21;EPS;CORTE;2022-08-05;8;0;8;6;N
JEQUIE;276;STC;CORTE;2022-08-19;7;7;0;6;N
GUANAMBI;138;EPS;CORTE;2022-08-15;5;5;0;2;N
CAMACARI;50;EPS;CORTE;2022-08-17;21;20;1;4;N
CAMACARI;51;STC;CORTE;2022-08-19;16;16;0;6;N
ITABUNA;229;STC;RECORTE;2022-08-05;15;14;1;6;N
ITABUNA;232;EPS;BAIXA;2022-08-04;5;4;1;5;N
SENHOR DO BONFIM;452;EPS;CORTE;2022-08-08;10;10;0;2;N
IRECE;197;STC;CORTE;2022-08-15;11;11;0;2;N
ITAPOAN;251;EPS;CORTE;2022-08-02;23;19;4;3;N
LUIS EDUARDO MAGALHAES;320;EPS;CORTE;2022-08-15;7;7;0;2;N
BARREIRAS;16;EPS;CORTE;2022-08-16;35;34;1;3;N
IPIAU;188;EPS;CORTE;2022-08-15;8;8;0;2;N
IBOTIRAMA;155;EPS;CORTE;2022-08-23;14;13;1;3;N
CONCEICAO DO COITE;68;EPS;CORTE;2022-08-12;7;7;0;6;N
VALENCA;490;STC;CORTE;2022-08-02;17;17;0;3;N
SANTO ANTONIO DE JESUS;429;STC;CORTE;2022-08-19;13;13;0;6;N
RIBEIRA DO POMBAL;399;STC;CORTE;2022-08-18;11;11;0;5;N
VALENCA;487;EPS;CORTE;2022-08-22;30;27;3;2;S
VITORIA DA CONQUISTA;518;EPS;RECORTE;2022-08-25;16;13;3;5;N
JACOBINA;259;EPS;CORTE;2022-08-10;9;8;1;4;N
IBOTIRAMA;171;EPS;CORTE;2022-08-03;3;2;1;4;N
LIVRAMENTO DE NOSSA SENHORA;312;EPS;CORTE;2022-08-23;10;8;2;3;N
CONCEICAO DO COITE;68;STC;CORTE;2022-08-24;8;8;0;4;S
JACOBINA;260;STC;CORTE;2022-08-12;16;14;2;6;N
CAMACARI;51;STC;CORTE;2022-08-17;5;5;0;4;S
IBOTIRAMA;159;EPS;RECORTE;2022-08-25;7;6;1;5;N
IBOTIRAMA;170;EPS;CORTE;2022-08-15;7;7;0;2;N
LAURO DE FREITAS;294;STC;RECORTE;2022-08-09;16;11;5;3;N
PORTO SEGURO;363;EPS;CORTE;2022-08-08;5;5;0;2;N
ITAPETINGA;239;STC;CORTE;2022-08-19;9;9;0;6;N
ITABUNA;228;STC;RECORTE;2022-08-17;16;11;5;4;N
SANTO ANTONIO DE JESUS;433;STC;RECORTE;2022-08-19;11;7;4;6;S
GUANAMBI;142;EPS;RECORTE;2022-08-17;16;14;2;4;N
JACOBINA;258;EPS;CORTE;2022-08-22;8;8;0;2;N
FEIRA DE SANTANA NORTE;109;EPS;RECORTE;2022-08-25;36;36;0;5;N
FEIRA DE SANTANA NORTE;106;STC;CORTE;2022-08-25;23;23;0;5;N
IBOTIRAMA;156;STC;CORTE;2022-08-25;11;11;0;5;N
IPIAU;531;EPS;CORTE;2022-08-18;8;5;3;5;N
SERRINHA;468;EPS;RECORTE;2022-08-25;6;2;4;5;N
ESPLANADA;77;STC;CORTE;2022-08-05;11;0;11;6;N
IRECE;211;EPS;CORTE;2022-08-05;13;0;13;6;N
ITABERABA;216;STC;RECORTE;2022-08-24;21;21;0;4;N
VITORIA DA CONQUISTA;508;EPS;BAIXA;2022-08-22;20;0;20;2;N
PIRAJA;355;EPS;CORTE;2022-08-25;36;0;36;5;N
ILHEUS;178;EPS;CORTE;2022-08-25;27;0;27;5;N
IRECE;195;EPS;CORTE;2022-08-25;11;0;11;5;N
PERIPERI;348;STC;CORTE;2022-08-22;16;16;0;2;N
CANDEIAS;58;EPS;CORTE;2022-08-16;36;34;2;3;N
JUAZEIRO;290;EPS;CORTE;2022-08-16;30;28;2;3;N
IBOTIRAMA;167;EPS;CORTE;2022-08-02;4;4;0;3;N
JACOBINA;256;STC;CORTE;2022-08-11;16;15;1;5;N
JACOBINA;259;EPS;RECORTE;2022-08-11;7;7;0;5;N
ITAPOAN;251;EPS;RECORTE;2022-08-03;18;18;0;4;N
CAMACARI;50;EPS;RECORTE;2022-08-18;12;12;0;5;N
POSTO DA MATA;386;EPS;CORTE;2022-08-22;3;3;0;2;N
EUNAPOLIS;85;EPS;CORTE;2022-08-22;7;7;0;2;N
JEQUIE;271;EPS;CORTE;2022-08-16;13;13;0;3;N
IRECE;192;EPS;CORTE;2022-08-12;13;13;0;6;N
EUNAPOLIS;102;STC;CORTE;2022-08-04;11;11;0;5;N
ITAPETINGA;249;STC;CORTE;2022-08-22;9;8;1;2;N
ITABUNA;234;STC;CORTE;2022-08-18;15;14;1;5;N
SENHOR DO BONFIM;452;STC;RECORTE;2022-08-23;11;11;0;3;N
BARREIRAS;16;EPS;RECORTE;2022-08-17;8;8;0;4;N
PIRAJA;352;EPS;CORTE;2022-08-12;16;15;1;6;N
FEIRA DE SANTANA SUL;123;STC;CORTE;2022-08-08;17;15;2;2;N
PIRAJA;355;EPS;DISJUNTOR;2022-08-08;15;14;1;2;N
IRECE;192;STC;CORTE;2022-08-24;15;15;0;4;S
SEABRA;436;EPS;CORTE;2022-08-18;11;11;0;5;N
CONCEICAO DO COITE;67;EPS;RECORTE;2022-08-25;6;3;3;5;N
VALENCA;487;EPS;RECORTE;2022-08-25;11;8;3;5;N
JACOBINA;255;STC;CORTE;2022-08-23;3;3;0;3;N
RIBEIRA DO POMBAL;410;STC;CORTE;2022-08-09;11;11;0;3;N
TEIXEIRA DE FREITAS;471;EPS;RECORTE;2022-08-08;2;2;0;2;N
LIVRAMENTO DE NOSSA SENHORA;310;STC;CORTE;2022-08-12;9;9;0;6;N
GUANAMBI;148;EPS;CORTE;2022-08-18;6;5;1;5;N
REMANSO;390;EPS;CORTE;2022-08-16;10;10;0;3;N
PIRAJA;353;STC;CORTE;2022-08-12;8;8;0;6;S
BRUMADO;38;EPS;CORTE;2022-08-11;6;5;1;5;N
FEIRA DE SANTANA SUL;127;STC;RECORTE;2022-08-10;1;0;1;4;N
GRACA;133;EPS;BAIXA;2022-08-22;1;0;1;2;N
ESPLANADA;82;STC;CORTE;2022-08-19;11;11;0;6;N
ALAGOINHAS;1;EPS;CORTE;2022-08-08;36;35;1;2;N
LAURO DE FREITAS;298;EPS;RECORTE;2022-08-19;21;13;8;6;S
POSTO DA MATA;383;STC;CORTE;2022-08-23;15;14;1;3;N
POSTO DA MATA;383;EPS;CORTE;2022-08-09;7;6;1;3;N
BRUMADO;35;STC;CORTE;2022-08-12;11;11;0;6;N
LUIS EDUARDO MAGALHAES;319;EPS;CORTE;2022-08-04;8;8;0;5;N
BARREIRAS;22;EPS;CORTE;2022-08-18;7;6;1;5;N
CAMACARI;57;STC;CORTE;2022-08-19;8;8;0;6;S
SANTO AMARO;421;EPS;DISJUNTOR;2022-08-16;6;6;0;3;N
LAURO DE FREITAS;294;EPS;CORTE;2022-08-19;15;13;2;6;N
SANTO AMARO;422;EPS;DISJUNTOR;2022-08-04;6;6;0;5;N
AMARGOSA;6;STC;CORTE;2022-08-23;18;18;0;3;N
SANTO AMARO;419;EPS;CORTE;2022-08-08;28;28;0;2;N
LAURO DE FREITAS;298;EPS;DISJUNTOR;2022-08-03;20;20;0;4;N
IBOTIRAMA;163;STC;CORTE;2022-08-15;9;9;0;2;N
JUAZEIRO;286;EPS;CORTE;2022-08-15;15;15;0;2;N
TEIXEIRA DE FREITAS;481;EPS;RECORTE;2022-08-11;16;16;0;5;N
PAULO AFONSO;331;STC;CORTE;2022-08-09;11;11;0;3;N
IPIAU;189;EPS;BAIXA;2022-08-04;6;6;0;5;N
BARREIRAS;16;EPS;BAIXA;2022-08-17;4;4;0;4;N
CAMACARI;50;EPS;BAIXA;2022-08-18;5;5;0;5;N
VALENCA;495;EPS;CORTE;2022-08-02;29;29;0;3;N
SANTO ANTONIO DE JESUS;426;EPS;CORTE;2022-08-18;4;4;0;5;N
VITORIA DA CONQUISTA;522;STC;CORTE;2022-08-15;11;11;0;2;N
LAURO DE FREITAS;296;STC;CORTE;2022-08-09;16;15;1;3;N
SANTO AMARO;424;STC;RECORTE;2022-08-12;13;7;6;6;N
ITAPETINGA;238;STC;CORTE;2022-08-08;9;7;2;2;N
JACOBINA;264;EPS;CORTE;2022-08-24;8;7;1;4;N
AMARGOSA;6;EPS;CORTE;2022-08-09;6;6;0;3;N
CANDEIAS;59;STC;RECORTE;2022-08-19;8;3;5;6;N
JUAZEIRO;288;STC;CORTE;2022-08-05;10;0;10;6;N
TEIXEIRA DE FREITAS;480;EPS;DISJUNTOR;2022-08-05;6;0;6;6;N
ESPLANADA;82;EPS;CORTE;2022-08-05;13;0;13;6;N
EUNAPOLIS;86;STC;RECORTE;2022-08-25;6;3;3;5;N
ITAPOAN;252;EPS;CORTE;2022-08-15;38;37;1;2;N
SENHOR DO BONFIM;454;STC;CORTE;2022-08-23;13;12;1;3;N
ESPLANADA;77;EPS;CORTE;2022-08-16;14;13;1;3;N
CONCEICAO DO COITE;65;EPS;DISJUNTOR;2022-08-08;2;2;0;2;N
ESPLANADA;78;STC;CORTE;2022-08-18;22;22;0;5;N
JUAZEIRO;290;EPS;BAIXA;2022-08-17;22;14;8;4;N
FEIRA DE SANTANA SUL;128;EPS;CORTE;2022-08-08;24;24;0;2;N
CONCEICAO DO COITE;62;EPS;CORTE;2022-08-12;7;7;0;6;N
IRECE;200;STC;CORTE;2022-08-04;7;7;0;5;N
CONCEICAO DO COITE;64;STC;CORTE;2022-08-02;11;7;4;3;N
ILHEUS;183;STC;CORTE;2022-08-04;19;19;0;5;N
BRUMADO;49;EPS;RECORTE;2022-08-03;3;3;0;4;N
CANDEIAS;58;STC;CORTE;2022-08-05;20;20;0;6;S
ITAPOAN;254;STC;CORTE;2022-08-03;10;10;0;4;S
BARREIRAS;19;STC;CORTE;2022-08-19;9;8;1;6;N
EUNAPOLIS;97;STC;RECORTE;2022-08-16;21;19;2;3;N
PAULO AFONSO;341;STC;CORTE;2022-08-12;11;10;1;6;N
BOM JESUS DA LAPA;30;EPS;CORTE;2022-08-11;5;5;0;5;N
JACOBINA;264;EPS;RECORTE;2022-08-25;8;8;0;5;N
ITABUNA;233;EPS;BAIXA;2022-08-17;8;8;0;4;N
SEABRA;443;EPS;CORTE;2022-08-08;7;7;0;2;N
VALENCA;495;EPS;RECORTE;2022-08-03;10;10;0;4;N
LAURO DE FREITAS;295;STC;RECORTE;2022-08-22;16;11;5;2;N
PORTO SEGURO;369;STC;RECORTE;2022-08-23;10;1;9;3;S
LUIS EDUARDO MAGALHAES;319;STC;RECORTE;2022-08-17;12;11;1;4;S
CANDEIAS;58;EPS;BAIXA;2022-08-17;11;10;1;4;N
JACOBINA;261;STC;CORTE;2022-08-25;5;5;0;5;N
EUNAPOLIS;91;EPS;CORTE;2022-08-24;19;19;0;4;N
LAURO DE FREITAS;298;EPS;BAIXA;2022-08-19;17;0;17;6;S
SANTA MARIA DA VITORIA;415;STC;CORTE;2022-08-04;9;9;0;5;N
LAURO DE FREITAS;293;EPS;CORTE;2022-08-08;24;24;0;2;N
SENHOR DO BONFIM;450;STC;CORTE;2022-08-22;13;13;0;2;N
CONCEICAO DO COITE;72;EPS;CORTE;2022-08-15;7;7;0;2;N
TEIXEIRA DE FREITAS;470;STC;CORTE;2022-08-09;17;16;1;3;N
VITORIA DA CONQUISTA;520;EPS;CORTE;2022-08-02;15;13;2;3;N
CAMACARI;55;EPS;CORTE;2022-08-08;25;24;1;2;N
RIBEIRA DO POMBAL;404;STC;CORTE;2022-08-09;11;11;0;3;N
SANTO ANTONIO DE JESUS;433;EPS;CORTE;2022-08-08;6;6;0;2;N
ITABUNA;227;EPS;CORTE;2022-08-16;14;13;1;3;N
SERRINHA;455;EPS;CORTE;2022-08-10;10;10;0;4;N
PAULO AFONSO;328;EPS;CORTE;2022-08-08;10;10;0;2;N
ITABUNA;228;EPS;CORTE;2022-08-04;17;16;1;5;N
VALENCA;491;STC;RECORTE;2022-08-16;17;16;1;3;N
BRUMADO;42;STC;CORTE;2022-08-02;11;11;0;3;N
GUANAMBI;150;EPS;CORTE;2022-08-19;6;6;0;6;N
LUIS EDUARDO MAGALHAES;319;EPS;BAIXA;2022-08-05;11;10;1;6;N
GRACA;133;EPS;CORTE;2022-08-23;44;41;3;3;N
ITABUNA;232;STC;RECORTE;2022-08-18;18;5;13;5;S
PAULO AFONSO;403;STC;CORTE;2022-08-04;11;11;0;5;N
PITUBA;359;EPS;CORTE;2022-08-23;17;17;0;3;N
IRECE;203;EPS;BAIXA;2022-08-04;7;6;1;5;N
AMARGOSA;6;EPS;BAIXA;2022-08-10;1;1;0;4;N
SANTO AMARO;424;EPS;CORTE;2022-08-22;12;11;1;2;N
SERRINHA;456;STC;CORTE;2022-08-12;10;10;0;6;N
VALENCA;493;EPS;BAIXA;2022-08-25;20;16;4;5;S
GRACA;134;EPS;CORTE;2022-08-11;21;19;2;5;N
CANDEIAS;58;STC;RECORTE;2022-08-08;16;15;1;2;N
GRACA;134;STC;CORTE;2022-08-25;14;14;0;5;N
ITAPOAN;253;STC;RECORTE;2022-08-16;11;2;9;3;S
TEIXEIRA DE FREITAS;482;EPS;CORTE;2022-08-23;16;16;0;3;N
BOM JESUS DA LAPA;25;EPS;CORTE;2022-08-22;5;5;0;2;N
ITABERABA;216;EPS;CORTE;2022-08-11;5;5;0;5;N
ITABERABA;215;EPS;CORTE;2022-08-23;3;3;0;3;N
ILHEUS;186;EPS;BAIXA;2022-08-04;10;0;10;5;N
CONCEICAO DO COITE;62;STC;RECORTE;2022-08-25;10;6;4;5;S
LUIS EDUARDO MAGALHAES;321;STC;CORTE;2022-08-19;16;16;0;6;N
PITUBA;358;EPS;DISJUNTOR;2022-08-18;29;29;0;5;N
FEIRA DE SANTANA NORTE;107;STC;CORTE;2022-08-15;21;20;1;2;N
VALENCA;489;EPS;CORTE;2022-08-02;10;10;0;3;N
CAMACARI;52;STC;CORTE;2022-08-09;32;28;4;3;N
PITUBA;357;STC;CORTE;2022-08-12;19;17;2;6;N
SANTO ANTONIO DE JESUS;428;EPS;CORTE;2022-08-19;8;8;0;6;N
CAMACARI;50;EPS;CORTE;2022-08-19;21;21;0;6;N
GRACA;136;STC;RECORTE;2022-08-02;34;33;1;3;N
IPIAU;189;STC;CORTE;2022-08-17;16;16;0;4;S
ALAGOINHAS;3;STC;CORTE;2022-08-23;19;18;1;3;N
ALAGOINHAS;4;STC;CORTE;2022-08-11;11;10;1;5;N
ITAPETINGA;238;EPS;CORTE;2022-08-19;12;12;0;6;N
JACOBINA;261;STC;CORTE;2022-08-02;3;3;0;3;N
SANTO AMARO;421;STC;CORTE;2022-08-23;21;20;1;3;N
ITAPOAN;253;EPS;BAIXA;2022-08-04;13;10;3;5;N
PITUBA;359;EPS;RECORTE;2022-08-24;39;31;8;4;N
IPIAU;532;EPS;CORTE;2022-08-08;11;10;1;2;N
IBOTIRAMA;170;EPS;CORTE;2022-08-17;7;6;1;4;N
ESPLANADA;77;EPS;BAIXA;2022-08-17;6;6;0;4;N
FEIRA DE SANTANA NORTE;111;STC;RECORTE;2022-08-17;15;10;5;4;N
LIVRAMENTO DE NOSSA SENHORA;304;STC;RECORTE;2022-08-11;6;5;1;5;S
RIBEIRA DO POMBAL;404;STC;RECORTE;2022-08-10;11;10;1;4;N
JACOBINA;259;EPS;CORTE;2022-08-12;9;9;0;6;N
VITORIA DA CONQUISTA;502;STC;CORTE;2022-08-11;11;11;0;5;N
JEQUIE;281;STC;RECORTE;2022-08-09;5;4;1;3;S
JACOBINA;258;EPS;CORTE;2022-08-24;8;7;1;4;N
GRACA;129;EPS;CORTE;2022-08-22;21;21;0;2;N
FEIRA DE SANTANA NORTE;115;EPS;BAIXA;2022-08-04;16;14;2;5;N
IRECE;198;STC;CORTE;2022-08-05;11;0;11;6;N
GUANAMBI;139;EPS;CORTE;2022-08-05;7;0;7;6;N
PAULO AFONSO;325;STC;CORTE;2022-08-09;3;3;0;3;N
LUIS EDUARDO MAGALHAES;321;EPS;CORTE;2022-08-05;7;0;7;6;N
IPIAU;189;EPS;CORTE;2022-08-05;11;0;11;6;N
FEIRA DE SANTANA SUL;122;EPS;CORTE;2022-08-08;24;23;1;2;N
PIRAJA;353;STC;CORTE;2022-08-16;108;99;9;3;N
ITABUNA;233;EPS;CORTE;2022-08-18;15;14;1;5;N
PIRAJA;354;STC;CORTE;2022-08-04;17;17;0;5;N
PIRAJA;353;EPS;CORTE;2022-08-02;23;22;1;3;N
JUAZEIRO;292;STC;CORTE;2022-08-08;9;9;0;2;N
CAMACARI;50;EPS;DISJUNTOR;2022-08-02;25;25;0;3;N
VITORIA DA CONQUISTA;511;EPS;CORTE;2022-08-12;14;12;2;6;N
IRECE;193;STC;CORTE;2022-08-16;22;19;3;3;N
JEQUIE;273;STC;CORTE;2022-08-08;11;11;0;2;N
IRECE;194;STC;CORTE;2022-08-04;6;6;0;5;N
SENHOR DO BONFIM;449;STC;CORTE;2022-08-11;10;10;0;5;N
ITAPOAN;251;EPS;RECORTE;2022-08-05;20;20;0;6;N
LAURO DE FREITAS;298;EPS;CORTE;2022-08-22;15;15;0;2;N
PERIPERI;349;STC;CORTE;2022-08-12;16;11;5;6;N
BARREIRAS;13;STC;CORTE;2022-08-19;21;20;1;6;N
IBOTIRAMA;167;STC;CORTE;2022-08-18;16;14;2;5;N
AMARGOSA;12;STC;CORTE;2022-08-02;16;16;0;3;N
IBOTIRAMA;166;EPS;CORTE;2022-08-16;7;7;0;3;N
JACOBINA;258;EPS;RECORTE;2022-08-25;8;6;2;5;N
AMARGOSA;11;EPS;BAIXA;2022-08-24;8;8;0;4;N
POSTO DA MATA;387;EPS;CORTE;2022-08-12;7;7;0;6;N
VITORIA DA CONQUISTA;518;EPS;BAIXA;2022-08-25;3;3;0;5;S
PERIPERI;347;EPS;CORTE;2022-08-22;16;14;2;2;N
VALENCA;489;EPS;RECORTE;2022-08-03;13;13;0;4;N
EUNAPOLIS;89;EPS;DISJUNTOR;2022-08-08;3;3;0;2;N
ILHEUS;174;EPS;CORTE;2022-08-24;16;16;0;4;S
EUNAPOLIS;85;EPS;CORTE;2022-08-24;20;18;2;4;N
CONCEICAO DO COITE;67;EPS;DISJUNTOR;2022-08-09;5;5;0;3;N
ITABERABA;222;STC;CORTE;2022-08-25;4;4;0;5;S
TEIXEIRA DE FREITAS;479;STC;RECORTE;2022-08-25;17;10;7;5;N
SANTO ANTONIO DE JESUS;427;EPS;CORTE;2022-08-08;6;6;0;2;N
IRECE;193;EPS;RECORTE;2022-08-03;18;17;1;4;N
SANTO ANTONIO DE JESUS;435;STC;CORTE;2022-08-23;57;56;1;3;N
IRECE;193;STC;RECORTE;2022-08-17;42;36;6;4;N
AMARGOSA;5;EPS;CORTE;2022-08-23;10;9;1;3;N
ESPLANADA;83;STC;CORTE;2022-08-09;11;11;0;3;N
SANTA MARIA DA VITORIA;535;EPS;RECORTE;2022-08-23;13;13;0;3;N
JUAZEIRO;286;EPS;CORTE;2022-08-17;15;14;1;4;N
SERRINHA;456;EPS;CORTE;2022-08-23;7;6;1;3;N
IRECE;203;STC;CORTE;2022-08-19;19;17;2;6;N
VALENCA;495;EPS;CORTE;2022-08-04;23;22;1;5;N
PORTO SEGURO;371;STC;CORTE;2022-08-02;16;15;1;3;N
FEIRA DE SANTANA SUL;122;STC;RECORTE;2022-08-23;21;19;2;3;N
PAULO AFONSO;331;STC;CORTE;2022-08-11;4;4;0;5;N
LAURO DE FREITAS;295;EPS;CORTE;2022-08-09;18;18;0;3;N
BRUMADO;36;STC;CORTE;2022-08-02;10;10;0;3;N
JEQUIE;282;EPS;CORTE;2022-08-09;19;17;2;3;N
IRECE;197;EPS;BAIXA;2022-08-04;7;3;4;5;N
SANTO AMARO;422;EPS;RECORTE;2022-08-24;21;16;5;4;N
ILHEUS;180;EPS;BAIXA;2022-08-04;10;8;2;5;N
GRACA;130;EPS;BAIXA;2022-08-11;30;24;6;5;N
VITORIA DA CONQUISTA;500;EPS;BAIXA;2022-08-22;11;11;0;2;N
VALENCA;494;EPS;CORTE;2022-08-16;7;7;0;3;N
CAMACARI;57;STC;CORTE;2022-08-23;9;7;2;3;N
LAURO DE FREITAS;295;STC;CORTE;2022-08-23;16;15;1;3;N
JACOBINA;534;EPS;CORTE;2022-08-23;5;5;0;3;N
PORTO SEGURO;369;EPS;CORTE;2022-08-12;9;9;0;6;N
EUNAPOLIS;97;EPS;CORTE;2022-08-03;5;5;0;4;N
ILHEUS;186;EPS;CORTE;2022-08-05;25;13;12;6;N
EUNAPOLIS;85;EPS;RECORTE;2022-08-25;3;1;2;5;N
PERIPERI;347;EPS;DISJUNTOR;2022-08-05;36;0;36;6;N
IRECE;203;EPS;CORTE;2022-08-05;13;0;13;6;N
JUAZEIRO;287;EPS;CORTE;2022-08-05;7;0;7;6;N
PERIPERI;348;STC;RECORTE;2022-08-25;19;6;13;5;N
LAURO DE FREITAS;293;EPS;DISJUNTOR;2022-08-16;27;26;1;3;N
GUANAMBI;142;STC;CORTE;2022-08-08;11;10;1;2;N
SANTA MARIA DA VITORIA;417;EPS;CORTE;2022-08-17;40;39;1;4;N
JACOBINA;262;STC;CORTE;2022-08-15;16;16;0;2;N
IPIAU;526;EPS;CORTE;2022-08-08;22;20;2;2;N
IBOTIRAMA;166;EPS;BAIXA;2022-08-17;12;10;2;4;N
VITORIA DA CONQUISTA;519;EPS;DISJUNTOR;2022-08-22;28;27;1;2;N
SERRINHA;468;STC;CORTE;2022-08-16;11;11;0;3;N
EUNAPOLIS;94;STC;CORTE;2022-08-04;11;11;0;5;N
SENHOR DO BONFIM;454;EPS;CORTE;2022-08-11;6;6;0;5;N
VALENCA;490;EPS;CORTE;2022-08-15;14;14;0;2;N
ESPLANADA;77;EPS;CORTE;2022-08-18;13;13;0;5;N
CONCEICAO DO COITE;67;EPS;RECORTE;2022-08-04;6;5;1;5;N
EUNAPOLIS;93;EPS;CORTE;2022-08-02;12;11;1;3;N
ITAPOAN;254;STC;CORTE;2022-08-05;10;10;0;6;S
CAMACARI;53;STC;CORTE;2022-08-22;16;16;0;2;N
CONCEICAO DO COITE;64;STC;CORTE;2022-08-04;11;11;0;5;N
BARREIRAS;18;EPS;CORTE;2022-08-19;7;7;0;6;N
FEIRA DE SANTANA SUL;128;EPS;CORTE;2022-08-10;18;17;1;4;N
PAULO AFONSO;340;EPS;CORTE;2022-08-12;8;7;1;6;N
IPIAU;190;EPS;CORTE;2022-08-18;8;8;0;5;N
AMARGOSA;5;EPS;RECORTE;2022-08-24;10;9;1;4;N
PERIPERI;348;EPS;BAIXA;2022-08-11;34;32;2;5;N
IRECE;198;EPS;CORTE;2022-08-16;10;7;3;3;N
FEIRA DE SANTANA SUL;127;EPS;CORTE;2022-08-22;18;18;0;2;N
EUNAPOLIS;97;EPS;RECORTE;2022-08-04;5;5;0;5;N
ITABUNA;172;STC;RECORTE;2022-08-04;3;2;1;5;S
SENHOR DO BONFIM;454;STC;CORTE;2022-08-25;13;12;1;5;N
SEABRA;442;EPS;CORTE;2022-08-22;8;6;2;2;N
POSTO DA MATA;378;EPS;CORTE;2022-08-22;3;3;0;2;N
CONCEICAO DO COITE;72;EPS;DISJUNTOR;2022-08-23;1;1;0;3;N
SANTA MARIA DA VITORIA;418;EPS;CORTE;2022-08-05;8;0;8;6;N
ITAPOAN;253;EPS;CORTE;2022-08-05;23;0;23;6;N
BOM JESUS DA LAPA;28;STC;CORTE;2022-08-02;10;10;0;3;N
BRUMADO;41;STC;CORTE;2022-08-16;10;10;0;3;N
FEIRA DE SANTANA SUL;124;STC;CORTE;2022-08-23;21;21;0;3;N
CAMACARI;55;EPS;CORTE;2022-08-10;54;53;1;4;N
JUAZEIRO;292;EPS;CORTE;2022-08-19;15;15;0;6;N
ITAPETINGA;244;STC;CORTE;2022-08-12;11;11;0;6;N
JEQUIE;267;STC;CORTE;2022-08-08;11;11;0;2;N
IBOTIRAMA;169;STC;CORTE;2022-08-19;16;16;0;6;N
ITABUNA;227;EPS;CORTE;2022-08-18;15;14;1;5;N
RIBEIRA DO POMBAL;404;STC;CORTE;2022-08-11;11;11;0;5;N
FEIRA DE SANTANA SUL;128;EPS;RECORTE;2022-08-11;20;19;1;5;N
FEIRA DE SANTANA NORTE;110;EPS;CORTE;2022-08-16;30;30;0;3;N
SEABRA;212;EPS;CORTE;2022-08-12;14;14;0;6;N
VITORIA DA CONQUISTA;505;EPS;CORTE;2022-08-12;15;14;1;6;N
SANTO ANTONIO DE JESUS;434;STC;CORTE;2022-08-12;19;19;0;6;N
SENHOR DO BONFIM;450;STC;CORTE;2022-08-22;12;12;0;2;S
GUANAMBI;152;STC;CORTE;2022-08-11;16;16;0;5;N
SANTA MARIA DA VITORIA;414;EPS;CORTE;2022-08-04;8;8;0;5;N
SEABRA;440;STC;CORTE;2022-08-11;11;10;1;5;N
IBOTIRAMA;163;EPS;BAIXA;2022-08-04;7;7;0;5;N
SANTO ANTONIO DE JESUS;9;EPS;CORTE;2022-08-22;8;8;0;2;N
TEIXEIRA DE FREITAS;473;EPS;RECORTE;2022-08-11;16;16;0;5;N
SENHOR DO BONFIM;453;EPS;RECORTE;2022-08-24;11;11;0;4;N
JACOBINA;264;EPS;CORTE;2022-08-03;6;5;1;4;N
ALAGOINHAS;1;EPS;BAIXA;2022-08-11;38;35;3;5;N
AMARGOSA;5;EPS;BAIXA;2022-08-24;1;1;0;4;N
EUNAPOLIS;97;EPS;BAIXA;2022-08-04;4;2;2;5;N
SANTO ANTONIO DE JESUS;432;EPS;CORTE;2022-08-22;4;4;0;2;N
TEIXEIRA DE FREITAS;473;STC;RECORTE;2022-08-23;4;3;1;3;S
CONCEICAO DO COITE;72;EPS;CORTE;2022-08-17;7;7;0;4;N
ITAPOAN;252;EPS;RECORTE;2022-08-18;1;1;0;5;N
PITUBA;359;EPS;CORTE;2022-08-25;14;0;14;5;N
GRACA;133;EPS;CORTE;2022-08-25;19;0;19;5;N
AMARGOSA;11;EPS;CORTE;2022-08-25;20;0;20;5;N
SANTO AMARO;423;EPS;DISJUNTOR;2022-08-19;12;11;1;6;N
SANTO ANTONIO DE JESUS;430;STC;CORTE;2022-08-11;13;13;0;5;N
TEIXEIRA DE FREITAS;481;STC;CORTE;2022-08-02;17;17;0;3;N
ITABUNA;172;EPS;CORTE;2022-08-16;14;14;0;3;N
PITUBA;359;EPS;DISJUNTOR;2022-08-08;16;16;0;2;N
RIBEIRA DO POMBAL;399;EPS;CORTE;2022-08-08;14;12;2;2;N
ALAGOINHAS;2;EPS;CORTE;2022-08-23;30;27;3;3;N
SANTO ANTONIO DE JESUS;429;STC;CORTE;2022-08-23;13;13;0;3;N
PITUBA;358;STC;CORTE;2022-08-02;38;37;1;3;N
CONCEICAO DO COITE;68;EPS;CORTE;2022-08-16;7;6;1;3;N
RIBEIRA DO POMBAL;399;STC;CORTE;2022-08-22;11;11;0;2;N
IBOTIRAMA;157;EPS;CORTE;2022-08-03;2;2;0;4;N
CAMACARI;51;STC;CORTE;2022-08-23;16;15;1;3;N
JACOBINA;261;STC;CORTE;2022-08-04;32;30;2;5;N
ESPLANADA;84;STC;CORTE;2022-08-22;11;10;1;2;N
VITORIA DA CONQUISTA;500;EPS;CORTE;2022-08-23;15;15;0;3;N
LUIS EDUARDO MAGALHAES;320;EPS;CORTE;2022-08-19;7;7;0;6;N
GRACA;130;EPS;CORTE;2022-08-12;21;21;0;6;N
SANTO AMARO;420;EPS;CORTE;2022-08-23;10;10;0;3;N
PORTO SEGURO;363;EPS;CORTE;2022-08-12;9;9;0;6;N
ITAPETINGA;239;STC;CORTE;2022-08-23;9;9;0;3;N
CAMACARI;52;STC;CORTE;2022-08-11;16;15;1;5;N
TEIXEIRA DE FREITAS;479;EPS;CORTE;2022-08-12;11;10;1;6;N
ALAGOINHAS;3;EPS;CORTE;2022-08-11;10;9;1;5;N
CAMACARI;51;EPS;CORTE;2022-08-09;18;17;1;3;N
CONCEICAO DO COITE;72;EPS;RECORTE;2022-08-18;6;3;3;5;N
FEIRA DE SANTANA NORTE;110;EPS;RECORTE;2022-08-17;6;4;2;4;N
JACOBINA;264;EPS;RECORTE;2022-08-04;8;8;0;5;N
CAMACARI;55;EPS;RECORTE;2022-08-11;24;24;0;5;N
LAURO DE FREITAS;293;EPS;RECORTE;2022-08-11;26;24;2;5;N
IBOTIRAMA;156;EPS;CORTE;2022-08-15;7;7;0;2;N
JEQUIE;276;EPS;CORTE;2022-08-09;16;16;0;3;N
IRECE;198;EPS;BAIXA;2022-08-17;5;5;0;4;N
SANTO AMARO;421;STC;CORTE;2022-08-25;21;19;2;5;N
ALAGOINHAS;3;STC;CORTE;2022-08-25;2;2;0;5;N
PITUBA;357;STC;CORTE;2022-08-12;6;6;0;6;S
JACOBINA;260;EPS;CORTE;2022-08-02;6;6;0;3;N
IPIAU;531;EPS;CORTE;2022-08-22;7;7;0;2;N
LUIS EDUARDO MAGALHAES;322;STC;CORTE;2022-08-09;11;10;1;3;N
VITORIA DA CONQUISTA;517;STC;CORTE;2022-08-05;11;0;11;6;N
FEIRA DE SANTANA NORTE;108;STC;CORTE;2022-08-05;38;0;38;6;N
IRECE;197;EPS;CORTE;2022-08-05;13;0;13;6;N
VALENCA;498;EPS;DISJUNTOR;2022-08-25;1;0;1;5;N
PIRAJA;352;EPS;CORTE;2022-08-16;45;44;1;3;N
IBOTIRAMA;154;STC;CORTE;2022-08-04;9;9;0;5;N
JUAZEIRO;291;EPS;CORTE;2022-08-08;18;16;2;2;N
LIVRAMENTO DE NOSSA SENHORA;310;EPS;CORTE;2022-08-02;5;5;0;3;N
LUIS EDUARDO MAGALHAES;318;STC;CORTE;2022-08-08;7;7;0;2;N
IRECE;193;EPS;CORTE;2022-08-04;39;39;0;5;N
CANDEIAS;59;STC;CORTE;2022-08-22;8;8;0;2;N
REMANSO;391;EPS;CORTE;2022-08-08;36;35;1;2;N
JACOBINA;256;STC;CORTE;2022-08-15;15;15;0;2;N
IRECE;193;STC;CORTE;2022-08-18;42;39;3;5;N
PERIPERI;348;EPS;CORTE;2022-08-12;30;29;1;6;N
IRECE;192;EPS;CORTE;2022-08-16;10;10;0;3;N
AMARGOSA;11;EPS;CORTE;2022-08-02;21;21;0;3;N
LAURO DE FREITAS;298;EPS;CORTE;2022-08-24;28;27;1;4;N
FEIRA DE SANTANA SUL;122;EPS;CORTE;2022-08-10;18;18;0;4;N
PIRAJA;353;EPS;CORTE;2022-08-04;42;38;4;5;N
PIRAJA;353;STC;CORTE;2022-08-16;51;51;0;3;S
SENHOR DO BONFIM;448;EPS;CORTE;2022-08-11;6;6;0;5;N
JACOBINA;261;STC;RECORTE;2022-08-03;7;6;1;4;S
PAULO AFONSO;407;EPS;CORTE;2022-08-18;8;8;0;5;N
ALAGOINHAS;2;EPS;RECORTE;2022-08-24;38;34;4;4;N
PAULO AFONSO;324;EPS;RECORTE;2022-08-10;6;4;2;4;N
BOM JESUS DA LAPA;33;STC;CORTE;2022-08-16;11;10;1;3;N
VITORIA DA CONQUISTA;520;EPS;BAIXA;2022-08-05;16;12;4;6;N
FEIRA DE SANTANA NORTE;110;EPS;BAIXA;2022-08-17;6;6;0;4;N
SANTA MARIA DA VITORIA;414;EPS;BAIXA;2022-08-05;1;1;0;6;N
CANDEIAS;59;EPS;CORTE;2022-08-08;20;20;0;2;N
FEIRA DE SANTANA NORTE;116;EPS;CORTE;2022-08-18;24;22;2;5;N
POSTO DA MATA;388;EPS;CORTE;2022-08-02;23;18;5;3;N
IRECE;197;STC;RECORTE;2022-08-18;12;6;6;5;S
PAULO AFONSO;334;EPS;CORTE;2022-08-12;7;6;1;6;N
ITAPETINGA;249;STC;CORTE;2022-08-24;7;7;0;4;S
PITUBA;357;STC;RECORTE;2022-08-15;21;16;5;2;N
ITAPETINGA;249;EPS;CORTE;2022-08-12;10;10;0;6;N
IBOTIRAMA;157;STC;RECORTE;2022-08-18;6;6;0;5;N
RIBEIRA DO POMBAL;409;STC;CORTE;2022-08-25;11;11;0;5;N
IRECE;198;STC;RECORTE;2022-08-08;16;16;0;2;N
LIVRAMENTO DE NOSSA SENHORA;310;STC;CORTE;2022-08-16;8;8;0;3;N
FEIRA DE SANTANA NORTE;118;STC;CORTE;2022-08-08;1;1;0;2;N
PORTO SEGURO;370;STC;CORTE;2022-08-16;21;20;1;3;N
AMARGOSA;11;EPS;RECORTE;2022-08-03;20;19;1;4;N
ILHEUS;187;STC;CORTE;2022-08-09;16;15;1;3;N
JUAZEIRO;286;EPS;CORTE;2022-08-19;15;14;1;6;N
IBOTIRAMA;163;STC;CORTE;2022-08-19;16;13;3;6;N
POSTO DA MATA;388;EPS;RECORTE;2022-08-03;6;5;1;4;N
PITUBA;359;EPS;RECORTE;2022-08-03;42;42;0;4;N
SANTO AMARO;421;STC;CORTE;2022-08-02;9;9;0;3;N
VITORIA DA CONQUISTA;521;EPS;CORTE;2022-08-17;30;27;3;4;N
GRACA;137;STC;CORTE;2022-08-16;17;14;3;3;N
BOM JESUS DA LAPA;29;STC;CORTE;2022-08-15;11;11;0;2;N
CANDEIAS;58;EPS;DISJUNTOR;2022-08-03;11;11;0;4;N
LIVRAMENTO DE NOSSA SENHORA;306;STC;CORTE;2022-08-15;4;4;0;2;N
VITORIA DA CONQUISTA;508;STC;CORTE;2022-08-15;11;10;1;2;N
SANTO AMARO;419;EPS;CORTE;2022-08-12;22;19;3;6;N
FEIRA DE SANTANA NORTE;113;STC;CORTE;2022-08-19;11;11;0;6;N
IRECE;192;EPS;RECORTE;2022-08-17;5;4;1;4;N
ILHEUS;175;EPS;RECORTE;2022-08-17;9;9;0;4;N
FEIRA DE SANTANA NORTE;112;EPS;CORTE;2022-08-17;14;14;0;4;N
VALENCA;496;STC;CORTE;2022-08-08;21;21;0;2;N
RIBEIRA DO POMBAL;406;STC;CORTE;2022-08-12;11;11;0;6;N
JUAZEIRO;288;STC;CORTE;2022-08-09;9;8;1;3;N
CANDEIAS;59;STC;RECORTE;2022-08-23;16;13;3;3;N
FEIRA DE SANTANA NORTE;107;EPS;BAIXA;2022-08-04;24;23;1;5;N
ALAGOINHAS;2;EPS;BAIXA;2022-08-24;1;1;0;4;N
BRUMADO;35;EPS;CORTE;2022-08-02;6;5;1;3;N
FEIRA DE SANTANA SUL;122;EPS;RECORTE;2022-08-11;20;19;1;5;N
EUNAPOLIS;87;EPS;RECORTE;2022-08-03;5;5;0;4;N
LAURO DE FREITAS;298;EPS;RECORTE;2022-08-25;120;120;0;5;N
PORTO SEGURO;374;STC;RECORTE;2022-08-16;15;6;9;3;S
SANTO ANTONIO DE JESUS;434;EPS;CORTE;2022-08-23;8;8;0;3;N
PERIPERI;349;STC;RECORTE;2022-08-15;19;18;1;2;N
ITAPETINGA;245;STC;CORTE;2022-08-25;9;8;1;5;N
LAURO DE FREITAS;295;STC;CORTE;2022-08-25;16;16;0;5;N
REMANSO;392;STC;RECORTE;2022-08-11;11;10;1;5;N
SENHOR DO BONFIM;447;EPS;RECORTE;2022-08-24;7;7;0;4;N
PIRAJA;350;STC;CORTE;2022-08-05;17;0;17;6;N
IBOTIRAMA;163;EPS;CORTE;2022-08-05;12;0;12;6;N
VALENCA;494;EPS;CORTE;2022-08-18;7;7;0;5;N
AMARGOSA;5;EPS;CORTE;2022-08-25;20;0;20;5;N
FEIRA DE SANTANA SUL;127;EPS;CORTE;2022-08-24;18;15;3;4;N
PAULO AFONSO;325;EPS;CORTE;2022-08-22;7;7;0;2;N
JACOBINA;261;EPS;CORTE;2022-08-15;9;9;0;2;N
PIRAJA;353;EPS;BAIXA;2022-08-05;52;47;5;6;N
JEQUIE;277;EPS;CORTE;2022-08-22;5;5;0;2;N
SEABRA;443;EPS;CORTE;2022-08-12;14;14;0;6;N
ESPLANADA;78;STC;CORTE;2022-08-22;22;22;0;2;N
LUIS EDUARDO MAGALHAES;323;STC;CORTE;2022-08-22;21;21;0;2;N
JUAZEIRO;284;STC;CORTE;2022-08-08;9;8;1;2;N
FEIRA DE SANTANA SUL;128;EPS;CORTE;2022-08-12;18;18;0;6;N
ITABERABA;215;STC;CORTE;2022-08-15;11;11;0;2;N
SERRINHA;468;STC;CORTE;2022-08-18;11;11;0;5;N
ESPLANADA;78;EPS;CORTE;2022-08-08;17;17;0;2;N
IBOTIRAMA;159;STC;CORTE;2022-08-18;16;15;1;5;N
VITORIA DA CONQUISTA;519;EPS;DISJUNTOR;2022-08-24;30;28;2;4;N
IRECE;200;STC;CORTE;2022-08-08;10;9;1;2;N
VITORIA DA CONQUISTA;521;EPS;RECORTE;2022-08-18;16;15;1;5;N
JEQUIE;281;EPS;RECORTE;2022-08-24;10;7;3;4;N
BRUMADO;46;EPS;BAIXA;2022-08-17;3;3;0;4;N
IRECE;192;EPS;BAIXA;2022-08-17;6;6;0;4;N
IRECE;198;EPS;CORTE;2022-08-18;16;13;3;5;N
JEQUIE;279;STC;CORTE;2022-08-12;5;5;0;6;N
JUAZEIRO;288;STC;RECORTE;2022-08-10;1;1;0;4;N
ILHEUS;175;EPS;BAIXA;2022-08-17;7;1;6;4;N
TEIXEIRA DE FREITAS;472;EPS;CORTE;2022-08-24;9;8;1;4;N
EUNAPOLIS;92;EPS;CORTE;2022-08-16;14;14;0;3;N
SERRINHA;467;EPS;CORTE;2022-08-16;7;7;0;3;N
JUAZEIRO;287;STC;RECORTE;2022-08-22;16;15;1;2;N
BARREIRAS;20;STC;CORTE;2022-08-11;15;12;3;5;N
JACOBINA;263;STC;CORTE;2022-08-05;16;0;16;6;N
VALENCA;491;EPS;CORTE;2022-08-05;16;0;16;6;N
JUAZEIRO;290;EPS;BAIXA;2022-08-19;90;0;90;6;S
SANTO ANTONIO DE JESUS;435;STC;CORTE;2022-08-02;19;18;1;3;N
FEIRA DE SANTANA SUL;123;EPS;CORTE;2022-08-23;54;48;6;3;N
ITABUNA;232;EPS;RECORTE;2022-08-10;7;5;2;4;N
FEIRA DE SANTANA SUL;127;EPS;RECORTE;2022-08-25;30;24;6;5;N
VALENCA;486;EPS;CORTE;2022-08-16;6;6;0;3;N
GUANAMBI;138;STC;CORTE;2022-08-09;11;10;1;3;N
VITORIA DA CONQUISTA;506;EPS;CORTE;2022-08-02;13;13;0;3;N
ITAPOAN;252;EPS;DISJUNTOR;2022-08-02;26;23;3;3;N
IPIAU;188;STC;CORTE;2022-08-09;19;19;0;3;N
TEIXEIRA DE FREITAS;484;EPS;CORTE;2022-08-03;8;8;0;4;N
PORTO SEGURO;376;EPS;CORTE;2022-08-04;16;16;0;5;N
SERRINHA;456;EPS;CORTE;2022-08-02;5;5;0;3;N
IRECE;195;STC;CORTE;2022-08-19;21;21;0;6;N
GRACA;134;EPS;CORTE;2022-08-15;21;21;0;2;N
AMARGOSA;12;EPS;CORTE;2022-08-15;5;5;0;2;N
PAULO AFONSO;403;STC;CORTE;2022-08-08;11;11;0;2;N
BRUMADO;40;EPS;CORTE;2022-08-16;7;6;1;3;N
PIRAJA;355;STC;CORTE;2022-08-19;17;15;2;6;N
JUAZEIRO;284;STC;RECORTE;2022-08-09;16;12;4;3;N
RIBEIRA DO POMBAL;404;EPS;BAIXA;2022-08-23;13;12;1;3;N
PORTO SEGURO;375;EPS;CORTE;2022-08-16;18;18;0;3;N
PAULO AFONSO;341;EPS;RECORTE;2022-08-03;12;12;0;4;N
GRACA;135;EPS;BAIXA;2022-08-25;37;31;6;5;S
SANTO ANTONIO DE JESUS;434;STC;CORTE;2022-08-12;15;15;0;6;S
FEIRA DE SANTANA SUL;124;STC;CORTE;2022-08-25;21;21;0;5;N
IBOTIRAMA;168;EPS;CORTE;2022-08-19;7;6;1;6;N
IRECE;209;EPS;CORTE;2022-08-09;14;14;0;3;N
EUNAPOLIS;88;EPS;CORTE;2022-08-15;8;7;1;2;N
GRACA;131;EPS;CORTE;2022-08-02;19;16;3;3;N
GRACA;132;STC;CORTE;2022-08-04;17;17;0;5;N
FEIRA DE SANTANA NORTE;107;STC;CORTE;2022-08-19;11;10;1;6;N
SANTO AMARO;422;STC;CORTE;2022-08-15;9;8;1;2;N
FEIRA DE SANTANA NORTE;106;EPS;CORTE;2022-08-17;39;37;2;4;N
ESPLANADA;83;EPS;CORTE;2022-08-22;13;13;0;2;N
IRECE;205;STC;CORTE;2022-08-22;21;21;0;2;N
RIBEIRA DO POMBAL;399;EPS;CORTE;2022-08-10;11;11;0;4;N
VALENCA;498;STC;CORTE;2022-08-09;21;20;1;3;N
JACOBINA;259;EPS;CORTE;2022-08-16;8;7;1;3;N
LUIS EDUARDO MAGALHAES;322;STC;CORTE;2022-08-11;11;10;1;5;N
SEABRA;441;STC;RECORTE;2022-08-02;13;13;0;3;N
ITABERABA;217;EPS;RECORTE;2022-08-04;8;7;1;5;N
IBOTIRAMA;156;EPS;CORTE;2022-08-17;6;5;1;4;N
IPIAU;532;EPS;CORTE;2022-08-12;8;6;2;6;N
ITABUNA;172;EPS;CORTE;2022-08-18;15;15;0;5;N
VITORIA DA CONQUISTA;502;STC;CORTE;2022-08-15;11;11;0;2;N
CAMACARI;50;EPS;CORTE;2022-08-23;20;20;0;3;N
SANTO ANTONIO DE JESUS;428;EPS;CORTE;2022-08-23;8;8;0;3;N
PORTO SEGURO;373;EPS;DISJUNTOR;2022-08-23;16;16;0;3;N
ITABERABA;213;EPS;CORTE;2022-08-02;5;5;0;3;N
ITAPETINGA;239;STC;CORTE;2022-08-25;9;9;0;5;N
SENHOR DO BONFIM;446;STC;CORTE;2022-08-25;11;11;0;5;N
LUIS EDUARDO MAGALHAES;321;EPS;CORTE;2022-08-09;7;7;0;3;N
FEIRA DE SANTANA NORTE;107;EPS;CORTE;2022-08-05;21;0;21;6;N
SANTO AMARO;420;EPS;CORTE;2022-08-25;13;0;13;5;N
PERIPERI;349;EPS;CORTE;2022-08-02;22;22;0;3;N
CONCEICAO DO COITE;64;EPS;CORTE;2022-08-17;7;7;0;4;N
LUIS EDUARDO MAGALHAES;317;STC;CORTE;2022-08-22;21;20;1;2;N
RIBEIRA DO POMBAL;410;STC;CORTE;2022-08-15;11;11;0;2;N
VITORIA DA CONQUISTA;499;STC;CORTE;2022-08-02;11;10;1;3;N
JACOBINA;256;EPS;CORTE;2022-08-03;7;6;1;4;N
PERIPERI;349;STC;CORTE;2022-08-16;16;10;6;3;N
SANTO ANTONIO DE JESUS;426;STC;CORTE;2022-08-12;13;13;0;6;N
BOM JESUS DA LAPA;33;STC;CORTE;2022-08-18;16;16;0;5;N
CANDEIAS;58;EPS;CORTE;2022-08-22;36;35;1;2;N
CANDEIAS;59;EPS;CORTE;2022-08-10;19;15;4;4;N
SANTO AMARO;422;STC;RECORTE;2022-08-16;13;11;2;3;N
ALAGOINHAS;4;STC;RECORTE;2022-08-16;9;9;0;3;N
CONCEICAO DO COITE;65;STC;CORTE;2022-08-19;11;10;1;6;N
AMARGOSA;11;EPS;CORTE;2022-08-04;28;28;0;5;N
BRUMADO;48;STC;CORTE;2022-08-08;7;7;0;2;N
GRACA;131;EPS;RECORTE;2022-08-03;19;18;1;4;N
LUIS EDUARDO MAGALHAES;317;EPS;CORTE;2022-08-08;10;10;0;2;N
BOM JESUS DA LAPA;32;EPS;CORTE;2022-08-16;5;5;0;3;N
SENHOR DO BONFIM;453;EPS;RECORTE;2022-08-03;7;7;0;4;N
REMANSO;394;EPS;RECORTE;2022-08-24;1;1;0;4;N
GRACA;135;EPS;BAIXA;2022-08-04;22;19;3;5;N
IRECE;192;EPS;CORTE;2022-08-18;14;11;3;5;N
IPIAU;189;EPS;RECORTE;2022-08-10;8;8;0;4;N
FEIRA DE SANTANA NORTE;107;STC;RECORTE;2022-08-18;7;3;4;5;S
JACOBINA;255;EPS;CORTE;2022-08-15;9;9;0;2;N
ITAPETINGA;240;STC;RECORTE;2022-08-12;18;4;14;6;S
IPIAU;527;EPS;CORTE;2022-08-23;7;7;0;3;N
BOM JESUS DA LAPA;33;EPS;CORTE;2022-08-04;7;5;2;5;N
CONCEICAO DO COITE;65;EPS;CORTE;2022-08-05;9;0;9;6;N
ITABUNA;231;STC;CORTE;2022-08-11;32;29;3;5;N
VALENCA;495;EPS;CORTE;2022-08-08;30;26;4;2;N
POSTO DA MATA;383;EPS;CORTE;2022-08-15;7;7;0;2;N
GRACA;136;EPS;CORTE;2022-08-16;21;21;0;3;N
SANTO AMARO;420;EPS;CORTE;2022-08-02;15;15;0;3;N
LIVRAMENTO DE NOSSA SENHORA;305;EPS;CORTE;2022-08-15;6;6;0;2;N
LAURO DE FREITAS;298;EPS;DISJUNTOR;2022-08-09;30;29;1;3;N
JUAZEIRO;287;EPS;CORTE;2022-08-09;14;13;1;3;N
JUAZEIRO;291;EPS;RECORTE;2022-08-11;8;8;0;5;N
PERIPERI;347;EPS;DISJUNTOR;2022-08-09;36;34;2;3;N
CONCEICAO DO COITE;64;EPS;RECORTE;2022-08-18;6;6;0;5;N
AMARGOSA;6;EPS;CORTE;2022-08-15;5;5;0;2;N
LAURO DE FREITAS;296;STC;CORTE;2022-08-15;16;16;0;2;N
GRACA;137;EPS;CORTE;2022-08-04;25;20;5;5;N
SENHOR DO BONFIM;449;STC;RECORTE;2022-08-16;11;11;0;3;N
JUAZEIRO;288;STC;CORTE;2022-08-11;1;1;0;5;N
ITABUNA;233;EPS;RECORTE;2022-08-23;25;22;3;3;N
JACOBINA;256;EPS;RECORTE;2022-08-04;9;9;0;5;N
ESPLANADA;82;EPS;CORTE;2022-08-11;7;7;0;5;N
PERIPERI;349;EPS;RECORTE;2022-08-03;18;13;5;4;N
CANDEIAS;59;EPS;RECORTE;2022-08-11;20;17;3;5;N
GRACA;129;EPS;BAIXA;2022-08-25;8;8;0;5;S
SERRINHA;457;EPS;CORTE;2022-08-15;9;9;0;2;N
CANDEIAS;59;STC;RECORTE;2022-08-23;4;2;2;3;S
IRECE;203;EPS;CORTE;2022-08-09;14;14;0;3;N
ILHEUS;186;EPS;CORTE;2022-08-09;6;6;0;3;N
SERRINHA;458;EPS;CORTE;2022-08-03;10;10;0;4;N
LAURO DE FREITAS;295;STC;CORTE;2022-08-25;15;15;0;5;S
AMARGOSA;10;EPS;RECORTE;2022-08-17;5;4;1;4;N
PAULO AFONSO;336;STC;RECORTE;2022-08-03;4;4;0;4;S
IPIAU;527;EPS;RECORTE;2022-08-24;8;8;0;4;N
BOM JESUS DA LAPA;30;STC;CORTE;2022-08-05;8;0;8;6;N
CANDEIAS;58;EPS;DISJUNTOR;2022-08-05;27;0;27;6;N
PAULO AFONSO;345;EPS;CORTE;2022-08-05;4;0;4;6;N
CANDEIAS;59;STC;RECORTE;2022-08-25;16;7;9;5;N
BRUMADO;44;EPS;DISJUNTOR;2022-08-25;13;0;13;5;N
CAMACARI;52;EPS;CORTE;2022-08-24;19;19;0;4;N
ITAPOAN;253;EPS;CORTE;2022-08-09;24;22;2;3;N
ILHEUS;186;EPS;RECORTE;2022-08-10;7;7;0;4;N
CONCEICAO DO COITE;72;STC;CORTE;2022-08-09;11;11;0;3;N
PITUBA;356;STC;RECORTE;2022-08-04;20;13;7;5;S
POSTO DA MATA;388;EPS;BAIXA;2022-08-05;8;8;0;6;N
IRECE;199;EPS;CORTE;2022-08-08;7;7;0;2;N
PAULO AFONSO;328;STC;CORTE;2022-08-02;11;11;0;3;N
JEQUIE;278;EPS;CORTE;2022-08-12;20;20;0;6;N
GUANAMBI;142;STC;CORTE;2022-08-12;16;16;0;6;N
ESPLANADA;79;STC;CORTE;2022-08-12;13;12;1;6;N
SANTO AMARO;420;EPS;RECORTE;2022-08-03;18;18;0;4;N
ESPLANADA;77;EPS;CORTE;2022-08-22;12;12;0;2;N
LAURO DE FREITAS;293;STC;CORTE;2022-08-02;48;40;8;3;N
VALENCA;491;STC;CORTE;2022-08-19;6;6;0;6;S
IRECE;203;EPS;RECORTE;2022-08-10;8;7;1;4;N
REMANSO;391;EPS;BAIXA;2022-08-11;13;13;0;5;N
JACOBINA;256;EPS;BAIXA;2022-08-04;5;4;1;5;N
SENHOR DO BONFIM;454;EPS;CORTE;2022-08-15;12;12;0;2;N
ESPLANADA;78;STC;CORTE;2022-08-22;5;5;0;2;S
JACOBINA;261;EPS;CORTE;2022-08-17;8;7;1;4;N
JACOBINA;262;STC;CORTE;2022-08-19;16;16;0;6;N
ALAGOINHAS;2;EPS;RECORTE;2022-08-03;15;15;0;4;N
IPIAU;527;EPS;BAIXA;2022-08-24;4;4;0;4;N
TEIXEIRA DE FREITAS;479;STC;RECORTE;2022-08-04;11;7;4;5;S
LAURO DE FREITAS;297;STC;RECORTE;2022-08-04;16;12;4;5;N
SEABRA;444;EPS;CORTE;2022-08-02;6;6;0;3;N
PAULO AFONSO;340;EPS;CORTE;2022-08-16;8;8;0;3;N
LUIS EDUARDO MAGALHAES;322;EPS;CORTE;2022-08-22;7;6;1;2;N
JUAZEIRO;287;STC;RECORTE;2022-08-24;2;1;1;4;N
CONCEICAO DO COITE;64;EPS;BAIXA;2022-08-18;2;2;0;5;N
VALENCA;490;EPS;CORTE;2022-08-19;14;14;0;6;N
JACOBINA;262;EPS;CORTE;2022-08-05;9;0;9;6;N
ITABUNA;230;STC;RECORTE;2022-08-24;21;16;5;4;N
ITABUNA;228;EPS;CORTE;2022-08-10;60;59;1;4;N
GUANAMBI;138;STC;CORTE;2022-08-11;16;16;0;5;N
PORTO SEGURO;370;EPS;BAIXA;2022-08-05;8;8;0;6;N
SANTO ANTONIO DE JESUS;434;EPS;CORTE;2022-08-02;12;10;2;3;N
JUAZEIRO;292;EPS;CORTE;2022-08-23;15;15;0;3;N
BRUMADO;44;EPS;DISJUNTOR;2022-08-02;5;4;1;3;N
GUANAMBI;152;STC;CORTE;2022-08-15;16;16;0;2;N
IBOTIRAMA;169;STC;CORTE;2022-08-23;16;15;1;3;N
ILHEUS;179;STC;CORTE;2022-08-09;11;11;0;3;N
SENHOR DO BONFIM;451;EPS;CORTE;2022-08-02;8;8;0;3;N
JACOBINA;261;EPS;RECORTE;2022-08-18;9;9;0;5;N
BARREIRAS;14;EPS;CORTE;2022-08-22;6;6;0;2;N
PAULO AFONSO;402;EPS;CORTE;2022-08-08;10;10;0;2;N
ITAPETINGA;245;STC;CORTE;2022-08-04;9;9;0;5;N
BARREIRAS;16;STC;CORTE;2022-08-12;15;14;1;6;N
PORTO SEGURO;375;EPS;CORTE;2022-08-18;10;9;1;5;N
BOM JESUS DA LAPA;27;EPS;CORTE;2022-08-04;7;7;0;5;N
IBOTIRAMA;155;STC;CORTE;2022-08-19;16;16;0;6;N
ITAPOAN;252;EPS;DISJUNTOR;2022-08-04;26;25;1;5;N
EUNAPOLIS;94;STC;RECORTE;2022-08-09;14;13;1;3;N
JACOBINA;258;STC;CORTE;2022-08-18;16;14;2;5;N
GRACA;137;EPS;BAIXA;2022-08-05;1;1;0;6;N
SERRINHA;463;EPS;CORTE;2022-08-17;7;7;0;4;N
VALENCA;486;EPS;CORTE;2022-08-18;6;5;1;5;N
SENHOR DO BONFIM;451;STC;CORTE;2022-08-16;11;11;0;3;N
ITAPOAN;253;EPS;RECORTE;2022-08-10;14;7;7;4;N
ITABUNA;230;EPS;BAIXA;2022-08-10;3;1;2;4;N
PIRAJA;354;EPS;CORTE;2022-08-19;14;14;0;6;N
JACOBINA;263;STC;RECORTE;2022-08-08;16;16;0;2;N
ILHEUS;183;STC;RECORTE;2022-08-09;13;5;8;3;S
SEABRA;444;EPS;RECORTE;2022-08-03;2;2;0;4;N
PAULO AFONSO;340;EPS;RECORTE;2022-08-17;9;9;0;4;N
IRECE;203;EPS;BAIXA;2022-08-10;3;3;0;4;N
ILHEUS;177;EPS;CORTE;2022-08-19;10;10;0;6;N
SANTO AMARO;425;EPS;CORTE;2022-08-16;11;11;0;3;N
PAULO AFONSO;338;STC;CORTE;2022-08-05;7;0;7;6;N
GRACA;135;EPS;CORTE;2022-08-05;100;0;100;6;N
FEIRA DE SANTANA SUL;125;STC;CORTE;2022-08-15;1;0;1;2;N
GUANAMBI;150;EPS;CORTE;2022-08-25;4;0;4;5;N
ALAGOINHAS;3;EPS;CORTE;2022-08-15;10;10;0;2;N
VITORIA DA CONQUISTA;503;EPS;DISJUNTOR;2022-08-23;30;29;1;3;N
LUIS EDUARDO MAGALHAES;320;EPS;CORTE;2022-08-23;8;7;1;3;N
PITUBA;357;EPS;CORTE;2022-08-04;22;20;2;5;N
EUNAPOLIS;99;STC;CORTE;2022-08-22;14;14;0;2;N
VITORIA DA CONQUISTA;502;EPS;CORTE;2022-08-03;22;22;0;4;N
LUIS EDUARDO MAGALHAES;321;EPS;CORTE;2022-08-11;7;7;0;5;N
PITUBA;356;EPS;CORTE;2022-08-16;36;32;4;3;N
VITORIA DA CONQUISTA;501;EPS;CORTE;2022-08-15;14;14;0;2;N
PITUBA;357;STC;CORTE;2022-08-18;19;19;0;5;N
RIBEIRA DO POMBAL;399;EPS;CORTE;2022-08-12;10;10;0;6;N
SANTO AMARO;423;STC;CORTE;2022-08-03;19;19;0;4;S
ITABERABA;213;EPS;CORTE;2022-08-04;6;6;0;5;N
ITABUNA;225;STC;CORTE;2022-08-11;16;15;1;5;N
GRACA;130;EPS;CORTE;2022-08-16;21;18;3;3;N
AMARGOSA;11;EPS;DISJUNTOR;2022-08-12;4;4;0;6;N
SANTO AMARO;423;EPS;DISJUNTOR;2022-08-23;8;8;0;3;N
CANDEIAS;533;EPS;DISJUNTOR;2022-08-19;20;19;1;6;N
BRUMADO;37;STC;CORTE;2022-08-19;10;10;0;6;N
JACOBINA;261;EPS;BAIXA;2022-08-18;2;1;1;5;N
EUNAPOLIS;88;EPS;RECORTE;2022-08-18;3;3;0;5;N
ITAPETINGA;245;STC;RECORTE;2022-08-03;7;3;4;4;S
ITAPOAN;253;EPS;BAIXA;2022-08-10;6;2;4;4;N
ILHEUS;178;STC;RECORTE;2022-08-22;21;14;7;2;N
JUAZEIRO;288;EPS;CORTE;2022-08-22;5;5;0;2;N
ILHEUS;187;EPS;CORTE;2022-08-22;4;4;0;2;N
PITUBA;359;EPS;DISJUNTOR;2022-08-12;2;2;0;6;N
SANTA MARIA DA VITORIA;411;STC;CORTE;2022-08-09;11;11;0;3;N
PORTO SEGURO;373;EPS;DISJUNTOR;2022-08-25;29;0;29;5;N
JACOBINA;255;EPS;CORTE;2022-08-17;8;8;0;4;N
LUIS EDUARDO MAGALHAES;323;STC;RECORTE;2022-08-02;13;12;1;3;N
PERIPERI;348;EPS;CORTE;2022-08-16;26;25;1;3;N
VITORIA DA CONQUISTA;499;STC;CORTE;2022-08-04;11;11;0;5;N
ALAGOINHAS;1;STC;CORTE;2022-08-04;27;26;1;5;N
IRECE;193;EPS;CORTE;2022-08-08;42;39;3;2;N
CANDEIAS;59;EPS;CORTE;2022-08-12;18;17;1;6;N
IRECE;201;STC;CORTE;2022-08-23;10;10;0;3;N
RIBEIRA DO POMBAL;409;EPS;CORTE;2022-08-15;10;10;0;2;N
CANDEIAS;58;EPS;CORTE;2022-08-24;38;36;2;4;N
CAMACARI;52;STC;RECORTE;2022-08-16;13;7;6;3;N
PERIPERI;349;EPS;CORTE;2022-08-04;15;12;3;5;N
LUIS EDUARDO MAGALHAES;318;STC;CORTE;2022-08-12;11;11;0;6;N
ITAPETINGA;237;STC;CORTE;2022-08-02;9;9;0;3;N
PITUBA;356;EPS;RECORTE;2022-08-17;13;13;0;4;N
CAMACARI;50;EPS;DISJUNTOR;2022-08-08;30;29;1;2;N
FEIRA DE SANTANA NORTE;116;EPS;CORTE;2022-08-22;17;17;0;2;N
REMANSO;391;STC;CORTE;2022-08-24;12;12;0;4;S
REMANSO;393;STC;CORTE;2022-08-02;9;9;0;3;N
LIVRAMENTO DE NOSSA SENHORA;309;EPS;CORTE;2022-08-18;6;5;1;5;N
SANTO ANTONIO DE JESUS;428;EPS;RECORTE;2022-08-24;2;2;0;4;S
SANTO AMARO;422;STC;RECORTE;2022-08-18;21;17;4;5;N
CONCEICAO DO COITE;68;EPS;DISJUNTOR;2022-08-03;4;4;0;4;N
ITAPETINGA;249;EPS;CORTE;2022-08-16;10;9;1;3;N
BARREIRAS;13;EPS;CORTE;2022-08-11;6;6;0;5;N
GRACA;132;STC;RECORTE;2022-08-05;11;3;8;6;S
TEIXEIRA DE FREITAS;475;EPS;CORTE;2022-08-15;9;9;0;2;N
LUIS EDUARDO MAGALHAES;320;EPS;RECORTE;2022-08-24;5;5;0;4;N
JACOBINA;256;EPS;CORTE;2022-08-05;9;0;9;6;N
FEIRA DE SANTANA NORTE;108;STC;RECORTE;2022-08-10;3;0;3;4;N
EUNAPOLIS;88;EPS;BAIXA;2022-08-18;1;0;1;5;N
BOM JESUS DA LAPA;29;STC;CORTE;2022-08-19;9;9;0;6;N
SANTA MARIA DA VITORIA;417;STC;CORTE;2022-08-11;11;11;0;5;N
PERIPERI;347;EPS;DISJUNTOR;2022-08-11;44;39;5;5;N
GRACA;136;EPS;CORTE;2022-08-18;63;55;8;5;N
SANTA MARIA DA VITORIA;416;STC;CORTE;2022-08-23;16;16;0;3;N
JACOBINA;255;EPS;RECORTE;2022-08-18;9;8;1;5;N
IBOTIRAMA;164;STC;CORTE;2022-08-11;9;9;0;5;N
JEQUIE;282;EPS;CORTE;2022-08-15;15;15;0;2;N
IPIAU;526;STC;CORTE;2022-08-02;13;13;0;3;N
ILHEUS;173;STC;CORTE;2022-08-09;21;19;2;3;N
CANDEIAS;58;EPS;RECORTE;2022-08-25;28;15;13;5;N
ITAPETINGA;245;EPS;CORTE;2022-08-15;12;12;0;2;N
LAURO DE FREITAS;296;EPS;CORTE;2022-08-03;14;14;0;4;N
RIBEIRA DO POMBAL;406;STC;CORTE;2022-08-16;11;11;0;3;N
VITORIA DA CONQUISTA;513;STC;RECORTE;2022-08-09;17;10;7;3;N
LIVRAMENTO DE NOSSA SENHORA;311;STC;RECORTE;2022-08-09;11;10;1;3;N
SERRINHA;463;STC;RECORTE;2022-08-09;9;7;2;3;N
BOM JESUS DA LAPA;23;EPS;BAIXA;2022-08-04;6;6;0;5;N
TEIXEIRA DE FREITAS;480;EPS;BAIXA;2022-08-05;1;1;0;6;N
ITABERABA;218;EPS;CORTE;2022-08-18;3;3;0;5;N
RIBEIRA DO POMBAL;410;EPS;RECORTE;2022-08-04;7;6;1;5;N
FEIRA DE SANTANA NORTE;113;STC;CORTE;2022-08-23;1;1;0;3;N
ITABUNA;230;STC;CORTE;2022-08-25;21;21;0;5;N
JEQUIE;268;STC;CORTE;2022-08-25;11;11;0;5;N
ITABUNA;229;EPS;CORTE;2022-08-23;14;13;1;3;N
CONCEICAO DO COITE;74;EPS;CORTE;2022-08-22;2;2;0;2;N
ALAGOINHAS;4;EPS;BAIXA;2022-08-04;7;6;1;5;N
IBOTIRAMA;163;EPS;CORTE;2022-08-09;10;10;0;3;N
REMANSO;390;EPS;RECORTE;2022-08-25;1;1;0;5;N
LIVRAMENTO DE NOSSA SENHORA;306;EPS;CORTE;2022-08-05;4;0;4;6;N
SERRINHA;458;EPS;CORTE;2022-08-05;15;0;15;6;N
BARREIRAS;20;STC;CORTE;2022-08-15;15;15;0;2;N
LAURO DE FREITAS;293;EPS;DISJUNTOR;2022-08-22;17;17;0;2;N
FEIRA DE SANTANA SUL;128;EPS;CORTE;2022-08-16;18;18;0;3;N
SANTO ANTONIO DE JESUS;432;STC;CORTE;2022-08-16;26;24;2;3;N
JUAZEIRO;284;STC;CORTE;2022-08-12;14;14;0;6;N
LAURO DE FREITAS;293;STC;CORTE;2022-08-04;16;15;1;5;N
REMANSO;389;STC;RECORTE;2022-08-02;17;15;2;3;N
VITORIA DA CONQUISTA;518;EPS;CORTE;2022-08-08;20;20;0;2;N
PAULO AFONSO;328;STC;CORTE;2022-08-04;11;9;2;5;N
SANTO ANTONIO DE JESUS;435;STC;DISJUNTOR;2022-08-10;15;14;1;4;S
VALENCA;491;EPS;CORTE;2022-08-09;16;16;0;3;N
JACOBINA;263;STC;CORTE;2022-08-09;16;16;0;3;N
FEIRA DE SANTANA NORTE;113;EPS;RECORTE;2022-08-10;57;53;4;4;N
VITORIA DA CONQUISTA;504;STC;CORTE;2022-08-18;11;10;1;5;N
LUIS EDUARDO MAGALHAES;323;EPS;CORTE;2022-08-12;7;7;0;6;N
LAURO DE FREITAS;296;EPS;RECORTE;2022-08-04;20;14;6;5;N
CAMACARI;55;STC;CORTE;2022-08-02;14;14;0;3;S
ITABERABA;215;STC;CORTE;2022-08-19;21;21;0;6;N
ITABERABA;216;STC;CORTE;2022-08-05;41;41;0;6;S
IRECE;198;EPS;CORTE;2022-08-22;6;6;0;2;N
IBOTIRAMA;159;STC;CORTE;2022-08-22;16;14;2;2;N
LAURO DE FREITAS;294;EPS;DISJUNTOR;2022-08-10;15;12;3;4;N
PAULO AFONSO;340;EPS;CORTE;2022-08-18;8;7;1;5;N
CONCEICAO DO COITE;72;STC;CORTE;2022-08-11;10;10;0;5;N
IRECE;200;STC;CORTE;2022-08-12;7;7;0;6;N
POSTO DA MATA;385;STC;RECORTE;2022-08-08;19;14;5;2;N
ESPLANADA;78;EPS;CORTE;2022-08-12;14;14;0;6;N
VITORIA DA CONQUISTA;520;EPS;DISJUNTOR;2022-08-16;2;2;0;3;N
FEIRA DE SANTANA NORTE;117;EPS;BAIXA;2022-08-11;14;14;0;5;N
ESPLANADA;79;EPS;BAIXA;2022-08-24;3;3;0;4;N
TEIXEIRA DE FREITAS;475;EPS;BAIXA;2022-08-16;13;12;1;3;N
ITABUNA;227;STC;CORTE;2022-08-12;16;16;0;6;N
LUIS EDUARDO MAGALHAES;317;EPS;BAIXA;2022-08-11;10;2;8;5;N
JEQUIE;277;EPS;CORTE;2022-08-24;9;9;0;4;S
ITAPOAN;253;EPS;CORTE;2022-08-11;23;18;5;5;N
JACOBINA;261;EPS;CORTE;2022-08-19;8;8;0;6;N
JACOBINA;255;EPS;BAIXA;2022-08-18;4;4;0;5;N
SERRINHA;468;EPS;CORTE;2022-08-08;7;7;0;2;N
LIVRAMENTO DE NOSSA SENHORA;307;STC;RECORTE;2022-08-08;5;5;0;2;N
PORTO SEGURO;366;EPS;CORTE;2022-08-05;6;0;6;6;N
BARREIRAS;18;EPS;CORTE;2022-08-25;6;0;6;5;N
IRECE;210;STC;CORTE;2022-08-15;11;11;0;2;N
ITAPOAN;252;EPS;RECORTE;2022-08-22;70;61;9;2;S
FEIRA DE SANTANA SUL;125;EPS;CORTE;2022-08-03;14;14;0;4;N
TEIXEIRA DE FREITAS;469;EPS;CORTE;2022-08-15;9;8;1;2;N
SERRINHA;465;STC;CORTE;2022-08-09;11;10;1;3;N
SENHOR DO BONFIM;450;EPS;CORTE;2022-08-16;22;21;1;3;N
BARREIRAS;17;STC;CORTE;2022-08-02;10;10;0;3;N
REMANSO;394;STC;CORTE;2022-08-15;9;8;1;2;N
FEIRA DE SANTANA SUL;124;EPS;CORTE;2022-08-15;18;18;0;2;N
SEABRA;439;EPS;CORTE;2022-08-15;16;15;1;2;N
ITAPOAN;250;STC;CORTE;2022-08-12;19;14;5;6;N
ITAPOAN;252;EPS;RECORTE;2022-08-24;140;135;5;4;N
PIRAJA;355;EPS;CORTE;2022-08-09;17;16;1;3;N
SENHOR DO BONFIM;451;EPS;CORTE;2022-08-04;7;7;0;5;N
BRUMADO;44;EPS;DISJUNTOR;2022-08-04;5;4;1;5;N
VALENCA;491;EPS;RECORTE;2022-08-10;26;25;1;4;N
SERRINHA;463;EPS;CORTE;2022-08-19;6;5;1;6;N
POSTO DA MATA;383;EPS;BAIXA;2022-08-18;17;16;1;5;N
SENHOR DO BONFIM;451;STC;CORTE;2022-08-16;12;12;0;3;S
IPIAU;527;EPS;RECORTE;2022-08-03;8;8;0;4;N
BARREIRAS;20;STC;RECORTE;2022-08-16;15;11;4;3;N
EUNAPOLIS;88;EPS;CORTE;2022-08-19;8;8;0;6;N
LUIS EDUARDO MAGALHAES;319;STC;CORTE;2022-08-25;9;8;1;5;N
EUNAPOLIS;102;EPS;CORTE;2022-08-23;14;14;0;3;N
TEIXEIRA DE FREITAS;470;EPS;CORTE;2022-08-03;7;7;0;4;N
ITABUNA;236;STC;CORTE;2022-08-25;14;14;0;5;S
IRECE;195;EPS;CORTE;2022-08-09;14;13;1;3;N
GUANAMBI;153;STC;CORTE;2022-08-05;10;0;10;6;N
SEABRA;441;STC;CORTE;2022-08-05;6;0;6;6;N
VITORIA DA CONQUISTA;521;EPS;BAIXA;2022-08-22;5;0;5;2;N
CAMACARI;52;EPS;CORTE;2022-08-03;26;25;1;4;N
IRECE;205;EPS;CORTE;2022-08-12;13;13;0;6;N
VALENCA;497;STC;CORTE;2022-08-23;30;29;1;3;S
BOM JESUS DA LAPA;23;STC;CORTE;2022-08-19;16;16;0;6;N
SANTO AMARO;422;STC;CORTE;2022-08-19;42;40;2;6;N
SENHOR DO BONFIM;450;EPS;RECORTE;2022-08-17;11;11;0;4;N
FEIRA DE SANTANA SUL;125;EPS;RECORTE;2022-08-04;16;12;4;5;N
JUAZEIRO;291;STC;CORTE;2022-08-02;9;9;0;3;N
ITABUNA;172;EPS;CORTE;2022-08-22;17;17;0;2;N
SANTO AMARO;422;STC;CORTE;2022-08-17;40;40;0;4;S
ILHEUS;179;STC;RECORTE;2022-08-12;15;3;12;6;N
PITUBA;356;EPS;CORTE;2022-08-18;36;28;8;5;N
GRACA;130;EPS;CORTE;2022-08-18;63;59;4;5;N
IBOTIRAMA;164;EPS;CORTE;2022-08-22;7;7;0;2;N
RIBEIRA DO POMBAL;400;EPS;CORTE;2022-08-02;10;10;0;3;N
FEIRA DE SANTANA NORTE;107;EPS;CORTE;2022-08-09;91;87;4;3;N
TEIXEIRA DE FREITAS;470;EPS;RECORTE;2022-08-04;18;14;4;5;N
SEABRA;436;STC;CORTE;2022-08-16;11;11;0;3;N
JUAZEIRO;290;STC;CORTE;2022-08-12;7;7;0;6;S
IRECE;194;STC;DISJUNTOR;2022-08-16;13;13;0;3;S
ILHEUS;178;STC;DISJUNTOR;2022-08-04;20;20;0;5;S
PORTO SEGURO;376;STC;RECORTE;2022-08-23;21;18;3;3;N
ILHEUS;178;EPS;RECORTE;2022-08-10;7;7;0;4;N
PAULO AFONSO;332;EPS;CORTE;2022-08-16;8;8;0;3;N
GUANAMBI;148;EPS;CORTE;2022-08-02;7;7;0;3;N
ALAGOINHAS;4;STC;CORTE;2022-08-19;16;16;0;6;N
LAURO DE FREITAS;298;STC;CORTE;2022-08-16;5;5;0;3;S
IBOTIRAMA;166;STC;CORTE;2022-08-12;6;6;0;6;N
ITAPETINGA;244;EPS;RECORTE;2022-08-05;4;4;0;6;N
VITORIA DA CONQUISTA;525;STC;CORTE;2022-08-12;11;11;0;6;N
BRUMADO;38;STC;CORTE;2022-08-09;11;10;1;3;N
PAULO AFONSO;336;EPS;RECORTE;2022-08-16;5;3;2;3;S
PAULO AFONSO;325;EPS;BAIXA;2022-08-25;13;11;2;5;S
GRACA;132;EPS;BAIXA;2022-08-18;9;8;1;5;N
ILHEUS;178;STC;RECORTE;2022-08-24;21;21;0;4;N
CAMACARI;52;EPS;BAIXA;2022-08-25;16;15;1;5;S
RIBEIRA DO POMBAL;404;EPS;RECORTE;2022-08-04;7;7;0;5;N
SANTO ANTONIO DE JESUS;435;STC;RECORTE;2022-08-05;9;6;3;6;S
ILHEUS;178;STC;RECORTE;2022-08-22;8;7;1;2;S
POSTO DA MATA;385;EPS;CORTE;2022-08-18;14;14;0;5;N
ESPLANADA;83;EPS;CORTE;2022-08-24;7;7;0;4;S
JUAZEIRO;288;EPS;CORTE;2022-08-24;10;10;0;4;N
ITAPETINGA;241;STC;CORTE;2022-08-05;9;0;9;6;N
ALAGOINHAS;4;EPS;CORTE;2022-08-05;20;0;20;6;N
BOM JESUS DA LAPA;23;EPS;CORTE;2022-08-05;6;0;6;6;N
SANTO AMARO;422;EPS;CORTE;2022-08-05;30;0;30;6;N
FEIRA DE SANTANA SUL;122;STC;CORTE;2022-08-04;1;1;0;5;N
IRECE;195;STC;RECORTE;2022-08-24;21;19;2;4;N
SANTO AMARO;423;EPS;DISJUNTOR;2022-08-25;9;0;9;5;N
VALENCA;492;EPS;CORTE;2022-08-22;21;21;0;2;N
REMANSO;392;EPS;CORTE;2022-08-02;44;43;1;3;N
SANTO ANTONIO DE JESUS;426;EPS;CORTE;2022-08-02;6;6;0;3;N
CAMACARI;50;EPS;DISJUNTOR;2022-08-10;20;20;0;4;N
CAMACARI;52;EPS;RECORTE;2022-08-04;18;17;1;5;N
LUIS EDUARDO MAGALHAES;319;STC;CORTE;2022-08-02;11;11;0;3;N
PAULO AFONSO;344;STC;CORTE;2022-08-09;7;6;1;3;N
LUIS EDUARDO MAGALHAES;317;EPS;CORTE;2022-08-12;7;7;0;6;N
IPIAU;532;EPS;RECORTE;2022-08-17;8;8;0;4;N
EUNAPOLIS;99;EPS;RECORTE;2022-08-11;4;4;0;5;N
ITAPETINGA;237;STC;CORTE;2022-08-04;8;7;1;5;N
LIVRAMENTO DE NOSSA SENHORA;310;EPS;CORTE;2022-08-08;5;5;0;2;N
FEIRA DE SANTANA SUL;125;EPS;BAIXA;2022-08-04;7;4;3;5;N
FEIRA DE SANTANA NORTE;107;EPS;RECORTE;2022-08-10;80;75;5;4;N
SANTO ANTONIO DE JESUS;427;STC;CORTE;2022-08-04;16;16;0;5;N
SANTO ANTONIO DE JESUS;426;STC;CORTE;2022-08-16;13;13;0;3;N
SANTA MARIA DA VITORIA;536;EPS;CORTE;2022-08-18;2;2;0;5;N
ILHEUS;178;EPS;BAIXA;2022-08-10;5;5;0;4;N
FEIRA DE SANTANA NORTE;108;STC;RECORTE;2022-08-12;8;8;0;6;N
JUAZEIRO;290;STC;RECORTE;2022-08-15;16;14;2;2;N
PITUBA;358;STC;RECORTE;2022-08-09;21;6;15;3;N
PITUBA;357;STC;RECORTE;2022-08-19;7;4;3;6;S
FEIRA DE SANTANA SUL;121;STC;RECORTE;2022-08-17;1;1;0;4;N
RIBEIRA DO POMBAL;409;EPS;CORTE;2022-08-17;10;10;0;4;N
JUAZEIRO;285;STC;CORTE;2022-08-25;9;9;0;5;N
LIVRAMENTO DE NOSSA SENHORA;301;STC;RECORTE;2022-08-08;8;8;0;2;N
CONCEICAO DO COITE;65;EPS;CORTE;2022-08-09;7;7;0;3;N
PORTO SEGURO;360;EPS;CORTE;2022-08-05;8;0;8;6;N
EUNAPOLIS;99;STC;RECORTE;2022-08-25;14;7;7;5;N
GUANAMBI;142;EPS;CORTE;2022-08-25;4;0;4;5;N
RIBEIRA DO POMBAL;405;EPS;CORTE;2022-08-16;10;9;1;3;N
SEABRA;442;STC;CORTE;2022-08-18;19;17;2;5;N
RIBEIRA DO POMBAL;409;EPS;RECORTE;2022-08-16;20;18;2;3;S
ITABUNA;231;STC;CORTE;2022-08-15;16;16;0;2;N
SERRINHA;459;STC;CORTE;2022-08-09;11;11;0;3;N
REMANSO;392;EPS;RECORTE;2022-08-03;8;8;0;4;N
RIBEIRA DO POMBAL;409;EPS;RECORTE;2022-08-18;11;11;0;5;N
VITORIA DA CONQUISTA;521;EPS;CORTE;2022-08-23;15;15;0;3;N
BRUMADO;43;STC;CORTE;2022-08-23;11;10;1;3;N
VITORIA DA CONQUISTA;507;EPS;CORTE;2022-08-19;14;14;0;6;N
SERRINHA;457;EPS;CORTE;2022-08-19;6;5;1;6;N
SANTO ANTONIO DE JESUS;427;STC;RECORTE;2022-08-03;7;4;3;4;S
JEQUIE;273;EPS;RECORTE;2022-08-03;9;9;0;4;N
CONCEICAO DO COITE;75;EPS;CORTE;2022-08-12;7;6;1;6;N
SENHOR DO BONFIM;445;EPS;CORTE;2022-08-04;7;7;0;5;N
ITABUNA;235;STC;RECORTE;2022-08-17;16;9;7;4;N
BOM JESUS DA LAPA;28;EPS;CORTE;2022-08-19;5;5;0;6;N
FEIRA DE SANTANA NORTE;113;EPS;CORTE;2022-08-11;15;13;2;5;N
TEIXEIRA DE FREITAS;477;STC;RECORTE;2022-08-08;17;17;0;2;N
LUIS EDUARDO MAGALHAES;313;EPS;CORTE;2022-08-11;7;7;0;5;N
ITAPOAN;251;STC;CORTE;2022-08-25;19;19;0;5;N
EUNAPOLIS;105;EPS;CORTE;2022-08-12;12;12;0;6;N
CANDEIAS;58;EPS;DISJUNTOR;2022-08-09;15;15;0;3;N
ITABUNA;230;STC;CORTE;2022-08-25;14;14;0;5;S
LAURO DE FREITAS;296;EPS;CORTE;2022-08-05;19;0;19;6;N
SANTO ANTONIO DE JESUS;431;EPS;CORTE;2022-08-16;4;4;0;3;N
SERRINHA;468;EPS;CORTE;2022-08-10;10;9;1;4;N
POSTO DA MATA;379;EPS;CORTE;2022-08-18;7;7;0;5;N
FEIRA DE SANTANA NORTE;108;EPS;CORTE;2022-08-22;16;15;1;2;N
IBOTIRAMA;160;STC;CORTE;2022-08-12;8;8;0;6;N
SANTO ANTONIO DE JESUS;9;STC;CORTE;2022-08-18;13;13;0;5;N
GRACA;134;STC;CORTE;2022-08-09;17;17;0;3;N
LAURO DE FREITAS;295;EPS;RECORTE;2022-08-18;11;9;2;5;N
ITAPETINGA;245;EPS;RECORTE;2022-08-18;13;13;0;5;N
VITORIA DA CONQUISTA;518;EPS;CORTE;2022-08-10;30;30;0;4;N
PAULO AFONSO;403;EPS;RECORTE;2022-08-24;2;2;0;4;N
GRACA;132;EPS;CORTE;2022-08-19;21;17;4;6;N
JACOBINA;262;EPS;CORTE;2022-08-09;9;8;1;3;N
CAMACARI;53;EPS;CORTE;2022-08-16;21;19;2;3;N
GUANAMBI;142;EPS;CORTE;2022-08-02;7;6;1;3;N
FEIRA DE SANTANA NORTE;112;EPS;RECORTE;2022-08-24;4;4;0;4;N
IRECE;199;EPS;CORTE;2022-08-12;13;13;0;6;N
VALENCA;493;EPS;BAIXA;2022-08-11;17;8;9;5;N
JACOBINA;263;STC;CORTE;2022-08-11;16;15;1;5;N
PIRAJA;350;STC;RECORTE;2022-08-12;17;6;11;6;N
VALENCA;491;EPS;CORTE;2022-08-11;14;13;1;5;N
SANTO ANTONIO DE JESUS;435;STC;DISJUNTOR;2022-08-12;15;15;0;6;S
BOM JESUS DA LAPA;29;STC;RECORTE;2022-08-22;13;12;1;2;N
ITABERABA;214;EPS;CORTE;2022-08-19;3;3;0;6;N
EUNAPOLIS;101;STC;CORTE;2022-08-25;11;11;0;5;N
JUAZEIRO;285;STC;CORTE;2022-08-02;2;2;0;3;N
BARREIRAS;16;EPS;CORTE;2022-08-02;45;44;1;3;N
VALENCA;486;EPS;CORTE;2022-08-22;7;7;0;2;N
FEIRA DE SANTANA SUL;124;EPS;CORTE;2022-08-17;18;18;0;4;N
IPIAU;188;STC;CORTE;2022-08-15;19;19;0;2;N
GUANAMBI;142;EPS;RECORTE;2022-08-03;20;20;0;4;N
ESPLANADA;79;EPS;RECORTE;2022-08-03;9;9;0;4;N
PIRAJA;355;EPS;CORTE;2022-08-11;48;47;1;5;N
PIRAJA;354;EPS;CORTE;2022-08-23;26;26;0;3;N
BARREIRAS;16;STC;CORTE;2022-08-16;15;14;1;3;N
JACOBINA;258;STC;CORTE;2022-08-22;16;16;0;2;N
JEQUIE;274;EPS;CORTE;2022-08-15;22;22;0;2;N
GUANAMBI;138;STC;CORTE;2022-08-15;16;15;1;2;N
LUIS EDUARDO MAGALHAES;320;STC;CORTE;2022-08-15;11;11;0;2;N
SENHOR DO BONFIM;450;EPS;CORTE;2022-08-18;20;19;1;5;N
SERRINHA;468;EPS;RECORTE;2022-08-11;7;6;1;5;N
IBOTIRAMA;159;EPS;RECORTE;2022-08-11;6;6;0;5;N
ITAPOAN;252;EPS;DISJUNTOR;2022-08-08;30;28;2;2;N
VITORIA DA CONQUISTA;518;EPS;RECORTE;2022-08-11;15;14;1;5;N
PORTO SEGURO;361;EPS;CORTE;2022-08-18;10;9;1;5;N
JACOBINA;258;EPS;CORTE;2022-08-08;11;10;1;2;N
VALENCA;490;EPS;RECORTE;2022-08-24;13;11;2;4;N
ITABERABA;224;EPS;CORTE;2022-08-22;4;4;0;2;N
FEIRA DE SANTANA NORTE;112;EPS;BAIXA;2022-08-24;1;1;0;4;N
ITAPETINGA;245;EPS;BAIXA;2022-08-18;5;5;0;5;N
IRECE;195;EPS;CORTE;2022-08-11;13;13;0;5;N
GUANAMBI;142;STC;RECORTE;2022-08-17;21;14;7;4;N
PORTO SEGURO;375;EPS;CORTE;2022-08-22;18;18;0;2;N
REMANSO;393;EPS;CORTE;2022-08-15;11;11;0;2;N
JUAZEIRO;285;STC;RECORTE;2022-08-03;5;5;0;4;N
IRECE;195;STC;CORTE;2022-08-25;21;18;3;5;N
BRUMADO;49;STC;CORTE;2022-08-25;11;11;0;5;N
ILHEUS;177;EPS;CORTE;2022-08-23;8;4;4;3;N
LIVRAMENTO DE NOSSA SENHORA;312;EPS;CORTE;2022-08-09;5;5;0;3;N
IRECE;211;STC;CORTE;2022-08-05;11;0;11;6;N
JEQUIE;276;STC;CORTE;2022-08-05;11;0;11;6;N
CAMACARI;51;STC;CORTE;2022-08-05;16;0;16;6;N
FEIRA DE SANTANA SUL;125;EPS;CORTE;2022-08-05;23;0;23;6;N
JACOBINA;262;STC;RECORTE;2022-08-24;5;3;2;4;N
GRACA;136;EPS;BAIXA;2022-08-19;11;0;11;6;S
LUIS EDUARDO MAGALHAES;318;EPS;CORTE;2022-08-25;6;0;6;5;N
PITUBA;357;EPS;CORTE;2022-08-08;27;24;3;2;N
ITAPETINGA;239;EPS;CORTE;2022-08-17;12;11;1;4;N
RIBEIRA DO POMBAL;399;EPS;CORTE;2022-08-16;10;10;0;3;N
POSTO DA MATA;386;EPS;CORTE;2022-08-08;8;8;0;2;N
EUNAPOLIS;101;STC;CORTE;2022-08-02;11;11;0;3;N
ITAPETINGA;240;STC;CORTE;2022-08-17;18;18;0;4;S
ESPLANADA;84;EPS;CORTE;2022-08-16;12;11;1;3;N
FEIRA DE SANTANA SUL;124;EPS;RECORTE;2022-08-18;42;38;4;5;N
SANTO AMARO;421;EPS;CORTE;2022-08-19;10;10;0;6;N
ALAGOINHAS;3;EPS;CORTE;2022-08-19;10;10;0;6;N
BRUMADO;37;STC;CORTE;2022-08-23;6;6;0;3;N
EUNAPOLIS;87;EPS;DISJUNTOR;2022-08-16;5;5;0;3;N
ILHEUS;173;EPS;CORTE;2022-08-22;25;25;0;2;N
GUANAMBI;148;EPS;CORTE;2022-08-04;7;6;1;5;N
SEABRA;436;EPS;CORTE;2022-08-04;6;4;2;5;N
JUAZEIRO;290;EPS;CORTE;2022-08-02;30;28;2;3;N
PIRAJA;350;EPS;CORTE;2022-08-22;13;13;0;2;N
EUNAPOLIS;85;EPS;CORTE;2022-08-08;8;7;1;2;N
BARREIRAS;20;EPS;BAIXA;2022-08-04;8;8;0;5;N
SENHOR DO BONFIM;447;STC;CORTE;2022-08-19;11;10;1;6;N
SANTO AMARO;423;STC;CORTE;2022-08-09;9;9;0;3;N
PAULO AFONSO;332;EPS;CORTE;2022-08-18;8;8;0;5;N
PIRAJA;353;EPS;DISJUNTOR;2022-08-18;23;22;1;5;N
SENHOR DO BONFIM;447;EPS;CORTE;2022-08-05;7;0;7;6;N
SANTO ANTONIO DE JESUS;430;EPS;CORTE;2022-08-05;6;0;6;6;N
SANTO AMARO;421;EPS;DISJUNTOR;2022-08-02;2;2;0;3;N
PAULO AFONSO;329;STC;CORTE;2022-08-19;16;16;0;6;N
ALAGOINHAS;1;STC;CORTE;2022-08-08;12;12;0;2;N
VALENCA;495;STC;CORTE;2022-08-02;17;17;0;3;N
IRECE;202;STC;CORTE;2022-08-15;11;11;0;2;N
TEIXEIRA DE FREITAS;481;STC;RECORTE;2022-08-09;10;4;6;3;S
ITAPETINGA;239;EPS;RECORTE;2022-08-18;13;13;0;5;N
LUIS EDUARDO MAGALHAES;318;EPS;CORTE;2022-08-02;9;9;0;3;N
TEIXEIRA DE FREITAS;477;STC;CORTE;2022-08-09;17;16;1;3;N
REMANSO;392;EPS;CORTE;2022-08-04;27;26;1;5;N
LUIS EDUARDO MAGALHAES;319;STC;CORTE;2022-08-04;7;6;1;5;N
VITORIA DA CONQUISTA;499;STC;CORTE;2022-08-08;11;11;0;2;N
PITUBA;357;STC;RECORTE;2022-08-23;21;18;3;3;N
SANTO ANTONIO DE JESUS;426;EPS;CORTE;2022-08-04;6;6;0;5;N
LAURO DE FREITAS;294;STC;CORTE;2022-08-19;16;16;0;6;N
PORTO SEGURO;376;EPS;BAIXA;2022-08-11;19;15;4;5;N
FEIRA DE SANTANA SUL;124;EPS;BAIXA;2022-08-18;15;13;2;5;N
IRECE;206;STC;RECORTE;2022-08-17;21;18;3;4;N
JUAZEIRO;290;STC;RECORTE;2022-08-17;16;8;8;4;N
SANTO AMARO;422;STC;RECORTE;2022-08-22;21;14;7;2;N
TEIXEIRA DE FREITAS;480;STC;RECORTE;2022-08-23;17;14;3;3;N
BRUMADO;47;EPS;CORTE;2022-08-12;8;8;0;6;N
TEIXEIRA DE FREITAS;479;EPS;DISJUNTOR;2022-08-03;1;1;0;4;N
RIBEIRA DO POMBAL;400;EPS;RECORTE;2022-08-05;6;6;0;6;N
PIRAJA;351;STC;RECORTE;2022-08-23;11;2;9;3;S
TEIXEIRA DE FREITAS;475;EPS;CORTE;2022-08-19;10;10;0;6;N
VALENCA;493;EPS;CORTE;2022-08-12;6;6;0;6;N
JUAZEIRO;286;STC;CORTE;2022-08-15;9;9;0;2;N
VALENCA;487;EPS;BAIXA;2022-08-11;17;2;15;5;N
PAULO AFONSO;343;EPS;CORTE;2022-08-09;7;7;0;3;N
ESPLANADA;82;STC;CORTE;2022-08-05;11;0;11;6;N
ILHEUS;183;EPS;CORTE;2022-08-25;27;0;27;5;N
GRACA;136;EPS;CORTE;2022-08-22;55;53;2;2;N
EUNAPOLIS;92;STC;CORTE;2022-08-12;11;9;2;6;N
IRECE;211;EPS;CORTE;2022-08-16;10;10;0;3;N
ESPLANADA;77;STC;CORTE;2022-08-16;11;11;0;3;N
ITAPETINGA;247;STC;CORTE;2022-08-09;9;9;0;3;N
ITAPOAN;252;STC;CORTE;2022-08-15;19;18;1;2;N
PORTO SEGURO;377;EPS;CORTE;2022-08-23;9;8;1;3;N
ITAPETINGA;245;EPS;CORTE;2022-08-19;12;12;0;6;N
VITORIA DA CONQUISTA;508;EPS;CORTE;2022-08-09;15;14;1;3;N
SANTA MARIA DA VITORIA;417;STC;CORTE;2022-08-15;11;11;0;2;N
ITABUNA;234;EPS;RECORTE;2022-08-17;8;8;0;4;N
VITORIA DA CONQUISTA;509;STC;CORTE;2022-08-11;11;11;0;5;N
REMANSO;391;EPS;RECORTE;2022-08-17;8;8;0;4;N
PIRAJA;351;EPS;BAIXA;2022-08-11;1;1;0;5;N
ITAPETINGA;239;EPS;BAIXA;2022-08-18;3;3;0;5;N
SEABRA;441;EPS;CORTE;2022-08-18;11;10;1;5;N
TEIXEIRA DE FREITAS;485;EPS;CORTE;2022-08-22;9;9;0;2;N
SERRINHA;458;EPS;CORTE;2022-08-09;12;12;0;3;N
LIVRAMENTO DE NOSSA SENHORA;306;EPS;CORTE;2022-08-09;4;4;0;3;N
REMANSO;389;STC;CORTE;2022-08-05;9;0;9;6;N
BOM JESUS DA LAPA;33;STC;RECORTE;2022-08-23;4;0;4;3;S
ITAPOAN;250;EPS;CORTE;2022-08-25;58;0;58;5;N
GRACA;133;EPS;CORTE;2022-08-09;42;41;1;3;N
ITABERABA;215;STC;CORTE;2022-08-23;21;20;1;3;N
BOM JESUS DA LAPA;25;EPS;CORTE;2022-08-08;7;7;0;2;N
ITABUNA;184;EPS;BAIXA;2022-08-04;15;14;1;5;N
SANTO ANTONIO DE JESUS;433;STC;CORTE;2022-08-08;19;18;1;2;N
FEIRA DE SANTANA NORTE;109;EPS;CORTE;2022-08-12;35;23;12;6;N
VITORIA DA CONQUISTA;504;STC;CORTE;2022-08-22;11;11;0;2;N
CAMACARI;55;STC;CORTE;2022-08-08;16;15;1;2;N
FEIRA DE SANTANA NORTE;108;EPS;CORTE;2022-08-24;74;65;9;4;N
GUANAMBI;142;EPS;CORTE;2022-08-04;7;7;0;5;N
LAURO DE FREITAS;293;STC;CORTE;2022-08-08;16;16;0;2;N
JUAZEIRO;284;EPS;CORTE;2022-08-02;15;15;0;3;N
IBOTIRAMA;161;STC;CORTE;2022-08-02;9;9;0;3;N
GRACA;134;STC;CORTE;2022-08-11;34;33;1;5;N
SANTA MARIA DA VITORIA;417;STC;RECORTE;2022-08-16;11;11;0;3;N
LUIS EDUARDO MAGALHAES;323;EPS;CORTE;2022-08-16;7;7;0;3;N
SANTO AMARO;424;STC;CORTE;2022-08-22;21;20;1;2;N
ITABERABA;216;STC;CORTE;2022-08-11;22;22;0;5;N
JUAZEIRO;285;STC;CORTE;2022-08-04;12;12;0;5;N
PITUBA;359;STC;CORTE;2022-08-23;19;17;2;3;N
ITABUNA;227;STC;CORTE;2022-08-16;16;16;0;3;N
VITORIA DA CONQUISTA;519;STC;CORTE;2022-08-12;15;15;0;6;S
JACOBINA;261;EPS;CORTE;2022-08-23;8;8;0;3;N
BARREIRAS;21;STC;CORTE;2022-08-05;13;13;0;6;S
ITABUNA;228;STC;CORTE;2022-08-02;12;12;0;3;S
SANTO ANTONIO DE JESUS;431;EPS;CORTE;2022-08-18;4;4;0;5;N
JEQUIE;278;EPS;CORTE;2022-08-18;18;18;0;5;N
SERRINHA;459;STC;RECORTE;2022-08-12;9;8;1;6;N
ITAPOAN;252;STC;RECORTE;2022-08-16;19;17;2;3;N
SERRINHA;468;EPS;CORTE;2022-08-12;9;8;1;6;N
BARREIRAS;20;EPS;CORTE;2022-08-05;8;0;8;6;N
EUNAPOLIS;91;STC;RECORTE;2022-08-25;5;1;4;5;N
IPIAU;530;EPS;CORTE;2022-08-18;8;8;0;5;N
JACOBINA;259;STC;CORTE;2022-08-12;14;13;1;6;N
ITAPOAN;250;EPS;CORTE;2022-08-02;50;41;9;3;N
LUIS EDUARDO MAGALHAES;319;EPS;CORTE;2022-08-15;7;7;0;2;N
BARREIRAS;16;STC;CORTE;2022-08-18;21;20;1;5;N
IBOTIRAMA;170;EPS;CORTE;2022-08-03;4;4;0;4;N
LIVRAMENTO DE NOSSA SENHORA;299;STC;CORTE;2022-08-09;9;7;2;3;N
SENHOR DO BONFIM;451;EPS;CORTE;2022-08-08;7;7;0;2;N
LIVRAMENTO DE NOSSA SENHORA;311;EPS;CORTE;2022-08-23;10;9;1;3;N
FEIRA DE SANTANA SUL;124;EPS;CORTE;2022-08-19;18;18;0;6;N
PORTO SEGURO;376;EPS;CORTE;2022-08-12;18;18;0;6;N
ILHEUS;179;STC;CORTE;2022-08-15;11;11;0;2;N
CONCEICAO DO COITE;72;STC;RECORTE;2022-08-16;11;9;2;3;N
SANTO AMARO;424;STC;RECORTE;2022-08-23;21;19;2;3;N
ITABERABA;215;EPS;RECORTE;2022-08-10;3;3;0;4;N
JACOBINA;258;EPS;CORTE;2022-08-10;9;9;0;4;N
PORTO SEGURO;366;EPS;RECORTE;2022-08-10;21;19;2;4;N
LAURO DE FREITAS;293;STC;RECORTE;2022-08-09;16;5;11;3;N
JACOBINA;257;EPS;CORTE;2022-08-22;8;7;1;2;N
GRACA;137;EPS;BAIXA;2022-08-11;1;1;0;5;N
IRECE;211;EPS;BAIXA;2022-08-17;6;6;0;4;N
SERRINHA;463;EPS;CORTE;2022-08-23;7;7;0;3;N
FEIRA DE SANTANA NORTE;111;STC;RECORTE;2022-08-03;1;0;1;4;N
CONCEICAO DO COITE;67;EPS;CORTE;2022-08-12;7;6;1;6;N
FEIRA DE SANTANA NORTE;108;EPS;RECORTE;2022-08-25;36;36;0;5;N
IBOTIRAMA;155;STC;CORTE;2022-08-25;16;15;1;5;N
SERRINHA;464;STC;CORTE;2022-08-25;9;9;0;5;N
CONCEICAO DO COITE;66;EPS;CORTE;2022-08-24;6;6;0;4;N
ILHEUS;178;STC;CORTE;2022-08-25;10;10;0;5;S
LUIS EDUARDO MAGALHAES;323;EPS;RECORTE;2022-08-17;5;5;0;4;N
IPIAU;189;STC;CORTE;2022-08-05;16;0;16;6;N
IBOTIRAMA;171;STC;CORTE;2022-08-05;5;0;5;6;N
CAMACARI;50;EPS;CORTE;2022-08-05;19;0;19;6;N
IRECE;210;EPS;CORTE;2022-08-05;8;0;8;6;N
ITABERABA;215;STC;RECORTE;2022-08-24;21;20;1;4;N
FEIRA DE SANTANA NORTE;109;STC;RECORTE;2022-08-25;40;27;13;5;S
PIRAJA;354;EPS;CORTE;2022-08-25;12;0;12;5;N
BRUMADO;48;EPS;CORTE;2022-08-25;3;0;3;5;N
IRECE;194;EPS;CORTE;2022-08-25;10;0;10;5;N
LAURO DE FREITAS;298;EPS;CORTE;2022-08-08;24;22;2;2;N
TEIXEIRA DE FREITAS;480;EPS;CORTE;2022-08-10;10;9;1;4;N
ITAPOAN;250;EPS;RECORTE;2022-08-03;54;52;2;4;N
POSTO DA MATA;385;EPS;CORTE;2022-08-22;11;11;0;2;N
LIVRAMENTO DE NOSSA SENHORA;309;STC;CORTE;2022-08-12;9;8;1;6;N
IRECE;192;STC;CORTE;2022-08-12;18;18;0;6;S
SENHOR DO BONFIM;446;EPS;CORTE;2022-08-19;10;9;1;6;N
IBOTIRAMA;166;EPS;CORTE;2022-08-02;4;4;0;3;N
ITABUNA;233;STC;CORTE;2022-08-18;18;17;1;5;N
VITORIA DA CONQUISTA;525;STC;CORTE;2022-08-16;11;11;0;3;N
PERIPERI;347;STC;CORTE;2022-08-22;16;15;1;2;N
SANTO ANTONIO DE JESUS;8;STC;CORTE;2022-08-09;13;13;0;3;N
ALAGOINHAS;4;EPS;CORTE;2022-08-09;18;16;2;3;N
TEIXEIRA DE FREITAS;470;EPS;RECORTE;2022-08-08;17;17;0;2;N
PORTO SEGURO;371;EPS;CORTE;2022-08-23;9;9;0;3;N
IRECE;206;STC;CORTE;2022-08-18;21;21;0;5;N
LAURO DE FREITAS;298;STC;CORTE;2022-08-22;16;15;1;2;N
JACOBINA;258;EPS;RECORTE;2022-08-11;7;7;0;5;N
IRECE;205;EPS;CORTE;2022-08-16;10;10;0;3;N
CANDEIAS;58;STC;CORTE;2022-08-18;8;8;0;5;N
SEABRA;437;STC;CORTE;2022-08-08;11;11;0;2;N
JACOBINA;255;STC;CORTE;2022-08-11;16;16;0;5;N
IBOTIRAMA;166;STC;CORTE;2022-08-16;8;5;3;3;N
ITABUNA;185;EPS;RECORTE;2022-08-17;8;7;1;4;N
IBOTIRAMA;170;STC;RECORTE;2022-08-16;15;14;1;3;S
GUANAMBI;142;EPS;BAIXA;2022-08-05;15;14;1;6;N
BRUMADO;37;EPS;CORTE;2022-08-11;6;6;0;5;N
AMARGOSA;11;EPS;DISJUNTOR;2022-08-18;3;3;0;5;N
EUNAPOLIS;85;STC;CORTE;2022-08-22;20;20;0;2;S
ITAPOAN;250;STC;RECORTE;2022-08-17;19;5;14;4;N
JUAZEIRO;289;EPS;CORTE;2022-08-16;15;14;1;3;N
IBOTIRAMA;167;STC;CORTE;2022-08-04;8;7;1;5;N
CAMACARI;51;STC;RECORTE;2022-08-08;16;16;0;2;N
SERRINHA;459;EPS;CORTE;2022-08-22;7;6;1;2;N
SANTA MARIA DA VITORIA;535;STC;CORTE;2022-08-22;7;4;3;2;N
PAULO AFONSO;403;EPS;RECORTE;2022-08-03;3;3;0;4;N
JUAZEIRO;290;STC;CORTE;2022-08-18;2;2;0;5;N
CANDEIAS;59;EPS;DISJUNTOR;2022-08-24;10;10;0;4;N
GUANAMBI;147;EPS;CORTE;2022-08-18;6;5;1;5;N
BOM JESUS DA LAPA;23;EPS;CORTE;2022-08-09;5;4;1;3;N
PIRAJA;352;STC;CORTE;2022-08-12;9;9;0;6;S
PIRAJA;351;EPS;CORTE;2022-08-12;16;16;0;6;N
FEIRA DE SANTANA SUL;122;STC;CORTE;2022-08-08;4;4;0;2;N
SANTO AMARO;422;EPS;CORTE;2022-08-09;22;22;0;3;N
EUNAPOLIS;88;EPS;RECORTE;2022-08-24;3;3;0;4;N
BARREIRAS;13;STC;CORTE;2022-08-05;13;0;13;6;N
FEIRA DE SANTANA SUL;126;STC;RECORTE;2022-08-10;1;0;1;4;N
LIVRAMENTO DE NOSSA SENHORA;311;EPS;RECORTE;2022-08-24;4;2;2;4;N
VITORIA DA CONQUISTA;503;EPS;BAIXA;2022-08-19;12;0;12;6;S
GRACA;132;EPS;BAIXA;2022-08-22;21;0;21;2;N
VALENCA;494;EPS;CORTE;2022-08-02;8;8;0;3;N
PAULO AFONSO;328;EPS;CORTE;2022-08-19;8;8;0;6;N
LAURO DE FREITAS;293;EPS;CORTE;2022-08-19;15;15;0;6;N
JUAZEIRO;285;EPS;CORTE;2022-08-15;15;15;0;2;N
JUAZEIRO;290;EPS;RECORTE;2022-08-05;39;39;0;6;N
AMARGOSA;5;EPS;CORTE;2022-08-09;12;12;0;3;N
PORTO SEGURO;370;EPS;DISJUNTOR;2022-08-18;19;15;4;5;N
IRECE;201;EPS;CORTE;2022-08-15;11;10;1;2;N
EUNAPOLIS;85;EPS;RECORTE;2022-08-11;4;4;0;5;N
LUIS EDUARDO MAGALHAES;317;EPS;CORTE;2022-08-16;7;6;1;3;N
SERRINHA;456;STC;CORTE;2022-08-23;11;11;0;3;N
BRUMADO;49;STC;CORTE;2022-08-04;11;10;1;5;N
PERIPERI;347;STC;RECORTE;2022-08-23;38;27;11;3;N
ALAGOINHAS;4;EPS;RECORTE;2022-08-10;16;16;0;4;N
LUIS EDUARDO MAGALHAES;318;EPS;CORTE;2022-08-04;8;7;1;5;N
TEIXEIRA DE FREITAS;477;STC;CORTE;2022-08-11;17;15;2;5;N
POSTO DA MATA;383;STC;CORTE;2022-08-11;17;17;0;5;N
BOM JESUS DA LAPA;23;EPS;RECORTE;2022-08-10;8;8;0;4;N
SANTO AMARO;422;EPS;RECORTE;2022-08-10;14;11;3;4;N
JACOBINA;534;EPS;CORTE;2022-08-09;9;9;0;3;N
SANTO AMARO;421;EPS;DISJUNTOR;2022-08-04;3;3;0;5;N
BRUMADO;48;EPS;CORTE;2022-08-02;6;6;0;3;N
TEIXEIRA DE FREITAS;480;EPS;RECORTE;2022-08-11;16;15;1;5;N
TEIXEIRA DE FREITAS;476;EPS;CORTE;2022-08-09;11;11;0;3;N
LAURO DE FREITAS;295;STC;CORTE;2022-08-09;16;15;1;3;N
ITABUNA;185;EPS;BAIXA;2022-08-17;8;7;1;4;N
IRECE;205;EPS;RECORTE;2022-08-17;5;3;2;4;N
JEQUIE;282;STC;CORTE;2022-08-09;5;5;0;3;N
IPIAU;188;EPS;BAIXA;2022-08-04;6;4;2;5;N
ITABUNA;226;STC;RECORTE;2022-08-04;3;1;2;5;S
JUAZEIRO;290;STC;RECORTE;2022-08-19;16;14;2;6;N
JACOBINA;263;EPS;CORTE;2022-08-24;8;8;0;4;N
PAULO AFONSO;343;EPS;CORTE;2022-08-11;5;4;1;5;N
PITUBA;357;STC;RECORTE;2022-08-23;8;4;4;3;S
EUNAPOLIS;85;STC;RECORTE;2022-08-25;1;0;1;5;N
GRACA;137;EPS;CORTE;2022-08-12;63;59;4;6;N
FEIRA DE SANTANA SUL;127;EPS;CORTE;2022-08-08;24;22;2;2;N
ITAPOAN;251;EPS;CORTE;2022-08-15;19;17;2;2;N
LUIS EDUARDO MAGALHAES;317;EPS;RECORTE;2022-08-17;5;5;0;4;N
ITAPOAN;253;STC;CORTE;2022-08-03;16;16;0;4;S
JUAZEIRO;290;EPS;BAIXA;2022-08-05;50;45;5;6;N
EUNAPOLIS;93;STC;CORTE;2022-08-02;19;19;0;3;N
PITUBA;357;EPS;BAIXA;2022-08-11;18;14;4;5;N
SENHOR DO BONFIM;453;STC;CORTE;2022-08-23;11;11;0;3;N
GUANAMBI;142;EPS;DISJUNTOR;2022-08-12;17;17;0;6;N
BARREIRAS;18;STC;CORTE;2022-08-19;21;19;2;6;N
VALENCA;490;STC;CORTE;2022-08-15;17;16;1;2;N
SANTA MARIA DA VITORIA;417;STC;CORTE;2022-08-17;25;25;0;4;N
SENHOR DO BONFIM;454;STC;CORTE;2022-08-11;13;12;1;5;N
ITAPOAN;253;EPS;DISJUNTOR;2022-08-23;16;16;0;3;N
ESPLANADA;77;STC;CORTE;2022-08-18;11;11;0;5;N
ITAPETINGA;247;STC;CORTE;2022-08-11;9;9;0;5;N
SEABRA;442;EPS;CORTE;2022-08-08;7;7;0;2;N
SANTO ANTONIO DE JESUS;427;STC;RECORTE;2022-08-09;15;13;2;3;N
IRECE;205;EPS;BAIXA;2022-08-17;6;6;0;4;N
VITORIA DA CONQUISTA;509;EPS;BAIXA;2022-08-23;19;1;18;3;N
IRECE;211;EPS;CORTE;2022-08-18;32;30;2;5;N
VALENCA;495;STC;RECORTE;2022-08-03;11;10;1;4;S
JEQUIE;281;STC;RECORTE;2022-08-22;11;6;5;2;N
IRECE;198;STC;CORTE;2022-08-16;11;11;0;3;N
CONCEICAO DO COITE;64;EPS;DISJUNTOR;2022-08-08;5;5;0;2;N
BOM JESUS DA LAPA;28;EPS;CORTE;2022-08-23;4;4;0;3;N
EUNAPOLIS;90;EPS;CORTE;2022-08-24;1;1;0;4;N
PAULO AFONSO;338;EPS;CORTE;2022-08-22;3;3;0;2;N
EUNAPOLIS;105;EPS;CORTE;2022-08-16;7;7;0;3;N
FEIRA DE SANTANA SUL;127;STC;CORTE;2022-08-22;1;1;0;2;N
ITAPOAN;253;STC;CORTE;2022-08-05;9;0;9;6;N
ITABUNA;231;EPS;CORTE;2022-08-05;17;0;17;6;N
JEQUIE;269;EPS;CORTE;2022-08-05;8;0;8;6;N
PORTO SEGURO;377;EPS;CORTE;2022-08-25;8;0;8;5;N
PORTO SEGURO;377;EPS;DISJUNTOR;2022-08-08;29;28;1;2;N
SANTO ANTONIO DE JESUS;432;EPS;CORTE;2022-08-08;6;6;0;2;N
PITUBA;358;EPS;CORTE;2022-08-23;17;17;0;3;N
SANTO ANTONIO DE JESUS;435;STC;DISJUNTOR;2022-08-16;15;15;0;3;S
ITABUNA;227;EPS;CORTE;2022-08-04;17;16;1;5;N
TEIXEIRA DE FREITAS;485;EPS;RECORTE;2022-08-25;91;76;15;5;N
VITORIA DA CONQUISTA;521;EPS;DISJUNTOR;2022-08-10;21;17;4;4;N
GUANAMBI;151;STC;CORTE;2022-08-09;11;11;0;3;N
SEABRA;212;STC;CORTE;2022-08-12;10;9;1;6;N
VITORIA DA CONQUISTA;519;EPS;CORTE;2022-08-02;15;14;1;3;N
GRACA;132;EPS;CORTE;2022-08-23;22;21;1;3;N
ITABERABA;214;EPS;CORTE;2022-08-23;4;4;0;3;N
BRUMADO;41;STC;CORTE;2022-08-02;11;11;0;3;N
IBOTIRAMA;161;STC;CORTE;2022-08-04;9;9;0;5;N
SANTO ANTONIO DE JESUS;432;STC;CORTE;2022-08-22;13;13;0;2;N
ITABUNA;230;EPS;RECORTE;2022-08-16;15;10;5;3;S
LUIS EDUARDO MAGALHAES;323;EPS;CORTE;2022-08-18;7;7;0;5;N
SANTA MARIA DA VITORIA;414;STC;CORTE;2022-08-04;10;10;0;5;N
GRACA;133;EPS;CORTE;2022-08-11;21;21;0;5;N
AMARGOSA;5;EPS;BAIXA;2022-08-10;3;3;0;4;N
PITUBA;359;EPS;CORTE;2022-08-11;20;17;3;5;N
JUAZEIRO;292;STC;CORTE;2022-08-19;9;9;0;6;N
CONCEICAO DO COITE;72;EPS;CORTE;2022-08-03;6;6;0;4;N
ITABUNA;231;STC;RECORTE;2022-08-18;11;4;7;5;S
ESPLANADA;77;STC;RECORTE;2022-08-19;16;13;3;6;N
PITUBA;359;STC;CORTE;2022-08-25;19;19;0;5;N
AMARGOSA;11;STC;CORTE;2022-08-25;18;18;0;5;N
TEIXEIRA DE FREITAS;481;EPS;CORTE;2022-08-23;16;16;0;3;N
EUNAPOLIS;89;EPS;DISJUNTOR;2022-08-19;4;3;1;6;N
ITABERABA;215;EPS;CORTE;2022-08-11;5;5;0;5;N
LIVRAMENTO DE NOSSA SENHORA;305;EPS;RECORTE;2022-08-24;1;1;0;4;N
EUNAPOLIS;103;STC;CORTE;2022-08-05;10;0;10;6;N
CONCEICAO DO COITE;73;STC;CORTE;2022-08-05;9;0;9;6;N
JACOBINA;260;STC;CORTE;2022-08-02;9;9;0;3;N
IBOTIRAMA;156;STC;CORTE;2022-08-15;9;9;0;2;N
FEIRA DE SANTANA NORTE;106;STC;CORTE;2022-08-15;21;21;0;2;N
CONCEICAO DO COITE;68;EPS;CORTE;2022-08-02;6;6;0;3;N
IPIAU;531;EPS;CORTE;2022-08-08;11;11;0;2;N
ITAPOAN;250;EPS;CORTE;2022-08-04;16;15;1;5;N
CAMACARI;53;EPS;RECORTE;2022-08-19;16;9;7;6;S
REMANSO;393;EPS;CORTE;2022-08-19;60;59;1;6;N
SANTO AMARO;420;STC;CORTE;2022-08-23;21;19;2;3;N
LUIS EDUARDO MAGALHAES;320;STC;CORTE;2022-08-19;13;13;0;6;N
PIRAJA;355;EPS;CORTE;2022-08-15;16;16;0;2;N
BARREIRAS;17;STC;CORTE;2022-08-08;12;12;0;2;N
ITABUNA;185;EPS;CORTE;2022-08-18;6;6;0;5;N
CAMACARI;51;STC;CORTE;2022-08-09;16;16;0;3;N
CONCEICAO DO COITE;72;EPS;RECORTE;2022-08-04;6;4;2;5;N
RIBEIRA DO POMBAL;399;STC;CORTE;2022-08-08;11;11;0;2;N
ITABUNA;226;EPS;RECORTE;2022-08-17;8;7;1;4;N
IRECE;195;EPS;CORTE;2022-08-15;13;13;0;2;N
BRUMADO;49;EPS;CORTE;2022-08-15;8;8;0;2;N
GRACA;130;STC;CORTE;2022-08-12;17;14;3;6;N
PORTO SEGURO;377;EPS;CORTE;2022-08-02;8;7;1;3;N
JACOBINA;258;EPS;CORTE;2022-08-12;9;7;2;6;N
FEIRA DE SANTANA SUL;125;EPS;CORTE;2022-08-09;19;19;0;3;N
ALAGOINHAS;3;STC;CORTE;2022-08-11;13;13;0;5;N
VITORIA DA CONQUISTA;501;STC;CORTE;2022-08-11;11;11;0;5;N
IPIAU;189;STC;CORTE;2022-08-05;15;15;0;6;S
FEIRA DE SANTANA NORTE;110;EPS;RECORTE;2022-08-03;18;17;1;4;N
VITORIA DA CONQUISTA;519;STC;RECORTE;2022-08-17;11;6;5;4;N
PITUBA;357;EPS;DISJUNTOR;2022-08-18;3;2;1;5;N
PITUBA;358;EPS;RECORTE;2022-08-24;26;18;8;4;N
PORTO SEGURO;361;EPS;CORTE;2022-08-22;9;9;0;2;N
SANTO ANTONIO DE JESUS;432;STC;RECORTE;2022-08-23;16;13;3;3;N
ILHEUS;178;EPS;CORTE;2022-08-15;23;23;0;2;N
BRUMADO;40;STC;RECORTE;2022-08-15;11;10;1;2;N
VITORIA DA CONQUISTA;500;STC;CORTE;2022-08-23;11;10;1;3;N
CAMACARI;55;STC;RECORTE;2022-08-09;8;3;5;3;S
ITAPETINGA;239;STC;CORTE;2022-08-09;9;8;1;3;N
JACOBINA;257;EPS;CORTE;2022-08-24;7;7;0;4;N
LUIS EDUARDO MAGALHAES;320;EPS;CORTE;2022-08-05;8;0;8;6;N
IBOTIRAMA;170;EPS;CORTE;2022-08-05;5;0;5;6;N
GUANAMBI;138;EPS;CORTE;2022-08-05;7;0;7;6;N
IPIAU;188;EPS;CORTE;2022-08-05;11;0;11;6;N
ALAGOINHAS;2;STC;CORTE;2022-08-23;1;1;0;3;N
TEIXEIRA DE FREITAS;471;EPS;BAIXA;2022-08-19;14;0;14;6;S
ILHEUS;179;EPS;BAIXA;2022-08-25;1;0;1;5;S
LIVRAMENTO DE NOSSA SENHORA;311;EPS;CORTE;2022-08-25;6;0;6;5;N
BOM JESUS DA LAPA;34;EPS;CORTE;2022-08-25;4;0;4;5;N
IRECE;207;STC;CORTE;2022-08-08;11;11;0;2;N
IRECE;194;STC;DISJUNTOR;2022-08-22;11;9;2;2;S
ITABUNA;226;EPS;BAIXA;2022-08-17;8;8;0;4;N
SANTO AMARO;422;EPS;CORTE;2022-08-11;22;21;1;5;N
PERIPERI;348;STC;CORTE;2022-08-12;16;15;1;6;N
LIVRAMENTO DE NOSSA SENHORA;310;STC;CORTE;2022-08-02;4;3;1;3;N
PIRAJA;352;EPS;CORTE;2022-08-02;69;64;5;3;N
FEIRA DE SANTANA NORTE;115;EPS;CORTE;2022-08-16;30;29;1;3;N
LAURO DE FREITAS;298;EPS;CORTE;2022-08-10;34;32;2;4;N
FEIRA DE SANTANA SUL;121;EPS;CORTE;2022-08-08;11;10;1;2;N
SENHOR DO BONFIM;447;STC;CORTE;2022-08-23;9;9;0;3;N
SENHOR DO BONFIM;447;EPS;CORTE;2022-08-09;6;5;1;3;N
VALENCA;487;EPS;RECORTE;2022-08-15;14;11;3;2;N
POSTO DA MATA;386;EPS;CORTE;2022-08-12;7;7;0;6;N
REMANSO;389;EPS;CORTE;2022-08-18;10;10;0;5;N
GUANAMBI;148;EPS;CORTE;2022-08-08;7;7;0;2;N
CANDEIAS;59;STC;CORTE;2022-08-08;12;12;0;2;N
PORTO SEGURO;377;EPS;RECORTE;2022-08-03;18;18;0;4;N
REMANSO;391;STC;CORTE;2022-08-08;6;6;0;2;N
ILHEUS;180;STC;RECORTE;2022-08-04;11;5;6;5;S
JUAZEIRO;291;STC;CORTE;2022-08-08;11;11;0;2;N
PAULO AFONSO;407;STC;CORTE;2022-08-18;11;7;4;5;N
VITORIA DA CONQUISTA;503;EPS;BAIXA;2022-08-23;29;27;2;3;N
JUAZEIRO;284;EPS;BAIXA;2022-08-05;18;18;0;6;N
LIVRAMENTO DE NOSSA SENHORA;309;STC;CORTE;2022-08-12;15;15;0;6;S
IRECE;192;STC;CORTE;2022-08-16;11;9;2;3;N
EUNAPOLIS;88;EPS;DISJUNTOR;2022-08-08;6;6;0;2;N
EUNAPOLIS;85;EPS;CORTE;2022-08-12;6;6;0;6;N
CAMACARI;50;STC;RECORTE;2022-08-22;16;15;1;2;N
JACOBINA;257;EPS;RECORTE;2022-08-25;8;4;4;5;N
SERRINHA;459;EPS;CORTE;2022-08-24;5;5;0;4;N
PAULO AFONSO;332;EPS;CORTE;2022-08-22;4;3;1;2;N
CONCEICAO DO COITE;72;EPS;BAIXA;2022-08-04;5;5;0;5;N
ALAGOINHAS;2;STC;RECORTE;2022-08-24;1;1;0;4;N
PORTO SEGURO;371;EPS;CORTE;2022-08-25;8;0;8;5;N
SENHOR DO BONFIM;447;EPS;RECORTE;2022-08-10;6;6;0;4;N
PITUBA;359;STC;RECORTE;2022-08-03;21;21;0;4;N
AMARGOSA;5;EPS;CORTE;2022-08-11;20;17;3;5;N
VALENCA;494;EPS;CORTE;2022-08-04;8;8;0;5;N
SANTO ANTONIO DE JESUS;426;EPS;CORTE;2022-08-08;6;6;0;2;N
LAURO DE FREITAS;298;EPS;RECORTE;2022-08-11;39;39;0;5;N
IRECE;192;EPS;RECORTE;2022-08-03;6;6;0;4;N
JUAZEIRO;286;STC;CORTE;2022-08-19;9;9;0;6;N
VALENCA;493;EPS;CORTE;2022-08-16;7;7;0;3;N
PORTO SEGURO;373;STC;RECORTE;2022-08-16;21;20;1;3;N
VITORIA DA CONQUISTA;520;EPS;CORTE;2022-08-15;15;14;1;2;N
ESPLANADA;80;EPS;CORTE;2022-08-19;9;9;0;6;N
IRECE;202;STC;CORTE;2022-08-19;12;12;0;6;N
JUAZEIRO;285;EPS;CORTE;2022-08-17;15;15;0;4;N
BRUMADO;48;EPS;CORTE;2022-08-04;6;6;0;5;N
LAURO DE FREITAS;295;STC;CORTE;2022-08-11;16;14;2;5;N
VALENCA;494;STC;CORTE;2022-08-18;11;11;0;5;N
ILHEUS;175;EPS;RECORTE;2022-08-03;10;10;0;4;N
IBOTIRAMA;161;EPS;CORTE;2022-08-15;7;7;0;2;N
SERRINHA;455;EPS;CORTE;2022-08-23;7;7;0;3;N
SANTO AMARO;421;EPS;RECORTE;2022-08-24;21;19;2;4;N
IBOTIRAMA;166;EPS;RECORTE;2022-08-05;5;5;0;6;N
ILHEUS;179;EPS;BAIXA;2022-08-04;10;9;1;5;N
PERIPERI;347;STC;RECORTE;2022-08-23;11;3;8;3;S
CAMACARI;57;STC;CORTE;2022-08-11;13;13;0;5;N
POSTO DA MATA;387;STC;RECORTE;2022-08-15;18;12;6;2;N
JEQUIE;282;STC;CORTE;2022-08-11;6;6;0;5;N
SERRINHA;459;EPS;RECORTE;2022-08-25;6;3;3;5;N
PORTO SEGURO;371;EPS;DISJUNTOR;2022-08-08;1;1;0;2;N
ALAGOINHAS;1;STC;CORTE;2022-08-12;2;2;0;6;N
EUNAPOLIS;97;STC;CORTE;2022-08-05;21;0;21;6;N
LAURO DE FREITAS;297;EPS;DISJUNTOR;2022-08-05;2;0;2;6;N
JUAZEIRO;286;EPS;CORTE;2022-08-05;17;0;17;6;N
PERIPERI;347;STC;RECORTE;2022-08-25;19;15;4;5;N
VALENCA;489;EPS;CORTE;2022-08-15;7;7;0;2;N
JACOBINA;261;STC;CORTE;2022-08-15;34;34;0;2;N
EUNAPOLIS;92;EPS;CORTE;2022-08-02;12;12;0;3;N
ESPLANADA;78;STC;CORTE;2022-08-08;22;22;0;2;N
EUNAPOLIS;92;STC;CORTE;2022-08-16;11;11;0;3;N
SERRINHA;467;STC;CORTE;2022-08-16;11;11;0;3;N
PORTO SEGURO;363;EPS;CORTE;2022-08-23;16;13;3;3;N
VALENCA;493;EPS;RECORTE;2022-08-17;16;13;3;4;N
SENHOR DO BONFIM;453;EPS;CORTE;2022-08-11;6;6;0;5;N
ILHEUS;186;STC;RECORTE;2022-08-08;17;17;0;2;N
TEIXEIRA DE FREITAS;472;EPS;CORTE;2022-08-10;10;10;0;4;N
IRECE;201;STC;DISJUNTOR;2022-08-12;18;18;0;6;S
ITAPOAN;253;STC;CORTE;2022-08-05;15;15;0;6;S
IRECE;197;EPS;CORTE;2022-08-16;10;10;0;3;N
SANTA MARIA DA VITORIA;417;STC;CORTE;2022-08-19;14;14;0;6;N
FEIRA DE SANTANA SUL;127;EPS;CORTE;2022-08-10;18;17;1;4;N
PERIPERI;347;EPS;BAIXA;2022-08-11;34;33;1;5;N
POSTO DA MATA;379;STC;CORTE;2022-08-12;7;7;0;6;N
JUAZEIRO;285;EPS;RECORTE;2022-08-18;8;7;1;5;N
SANTA MARIA DA VITORIA;535;EPS;BAIXA;2022-08-11;13;13;0;5;N
ALAGOINHAS;1;STC;RECORTE;2022-08-11;38;29;9;5;S
PIRAJA;350;EPS;BAIXA;2022-08-25;16;9;7;5;S
JUAZEIRO;287;STC;RECORTE;2022-08-08;16;16;0;2;N
GUANAMBI;141;STC;CORTE;2022-08-08;5;5;0;2;N
SENHOR DO BONFIM;453;STC;CORTE;2022-08-25;13;13;0;5;N
GUANAMBI;139;EPS;CORTE;2022-08-18;6;6;0;5;N
FEIRA DE SANTANA SUL;128;STC;CORTE;2022-08-12;3;3;0;6;N
BRUMADO;47;EPS;RECORTE;2022-08-17;4;4;0;4;N
ITABUNA;228;STC;CORTE;2022-08-08;12;12;0;2;N
IRECE;207;EPS;CORTE;2022-08-19;16;15;1;6;N
FEIRA DE SANTANA NORTE;109;EPS;CORTE;2022-08-16;30;26;4;3;N
IBOTIRAMA;168;STC;CORTE;2022-08-19;15;15;0;6;N
ITAPOAN;251;EPS;RECORTE;2022-08-18;80;79;1;5;N
VITORIA DA CONQUISTA;506;STC;CORTE;2022-08-02;11;11;0;3;N
ITAPOAN;253;STC;RECORTE;2022-08-08;19;16;3;2;N
JACOBINA;263;EPS;CORTE;2022-08-03;7;7;0;4;N
PORTO SEGURO;375;STC;CORTE;2022-08-16;15;15;0;3;N
RIBEIRA DO POMBAL;406;EPS;RECORTE;2022-08-11;9;9;0;5;N
PAULO AFONSO;334;EPS;CORTE;2022-08-23;7;7;0;3;N
GRACA;134;STC;CORTE;2022-08-15;17;17;0;2;N
ITAPETINGA;242;STC;CORTE;2022-08-22;16;12;4;2;S
FEIRA DE SANTANA NORTE;110;EPS;CORTE;2022-08-04;27;25;2;5;N
TEIXEIRA DE FREITAS;469;STC;CORTE;2022-08-11;17;16;1;5;N
SERRINHA;456;STC;CORTE;2022-08-02;11;11;0;3;N
ITAPETINGA;247;STC;RECORTE;2022-08-12;18;11;7;6;S
VITORIA DA CONQUISTA;503;EPS;CORTE;2022-08-24;14;14;0;4;N
LIVRAMENTO DE NOSSA SENHORA;302;EPS;CORTE;2022-08-12;6;5;1;6;N
FEIRA DE SANTANA SUL;127;EPS;RECORTE;2022-08-11;20;20;0;5;N
SANTO ANTONIO DE JESUS;435;EPS;RECORTE;2022-08-24;8;8;0;4;N
VALENCA;486;STC;CORTE;2022-08-16;17;16;1;3;N
VITORIA DA CONQUISTA;520;EPS;BAIXA;2022-08-16;3;2;1;3;N
EUNAPOLIS;102;STC;CORTE;2022-08-19;11;11;0;6;N
TEIXEIRA DE FREITAS;472;STC;RECORTE;2022-08-23;9;1;8;3;S
SANTO ANTONIO DE JESUS;8;EPS;CORTE;2022-08-22;4;4;0;2;N
SANTO AMARO;424;EPS;CORTE;2022-08-12;22;22;0;6;N
BRUMADO;40;EPS;CORTE;2022-08-02;6;6;0;3;N
SANTA MARIA DA VITORIA;412;EPS;CORTE;2022-08-16;7;7;0;3;N
PAULO AFONSO;341;STC;RECORTE;2022-08-03;1;1;0;4;N
SANTO ANTONIO DE JESUS;431;EPS;CORTE;2022-08-22;4;4;0;2;N
ILHEUS;178;EPS;DISJUNTOR;2022-08-23;32;32;0;3;N
ITAPETINGA;241;EPS;CORTE;2022-08-22;6;6;0;2;N
CONCEICAO DO COITE;72;EPS;CORTE;2022-08-05;9;0;9;6;N
POSTO DA MATA;387;EPS;CORTE;2022-08-25;16;0;16;5;N
GRACA;132;EPS;CORTE;2022-08-25;42;0;42;5;N
JACOBINA;263;EPS;RECORTE;2022-08-04;9;9;0;5;N
BARREIRAS;16;EPS;CORTE;2022-08-08;50;49;1;2;N
GRACA;129;EPS;CORTE;2022-08-12;21;21;0;6;N
JACOBINA;259;STC;CORTE;2022-08-16;16;15;1;3;N
ALAGOINHAS;1;EPS;CORTE;2022-08-23;30;28;2;3;N
ITABERABA;213;STC;CORTE;2022-08-02;11;10;1;3;N
VITORIA DA CONQUISTA;499;EPS;CORTE;2022-08-23;15;15;0;3;N
IBOTIRAMA;155;EPS;CORTE;2022-08-15;14;13;1;2;N
SANTO ANTONIO DE JESUS;428;STC;CORTE;2022-08-23;19;17;2;3;N
GRACA;131;STC;CORTE;2022-08-02;13;11;2;3;N
GRACA;134;STC;RECORTE;2022-08-16;34;27;7;3;N
CONCEICAO DO COITE;68;STC;CORTE;2022-08-18;11;11;0;5;N
ALAGOINHAS;2;EPS;CORTE;2022-08-11;30;29;1;5;N
REMANSO;395;STC;CORTE;2022-08-11;9;9;0;5;N
ITAPETINGA;242;EPS;RECORTE;2022-08-11;8;7;1;5;N
LUIS EDUARDO MAGALHAES;319;EPS;CORTE;2022-08-19;7;6;1;6;N
EUNAPOLIS;98;STC;CORTE;2022-08-18;21;21;0;5;N
ITAPETINGA;238;STC;CORTE;2022-08-23;9;9;0;3;N
CAMACARI;51;STC;CORTE;2022-08-11;16;16;0;5;N
ITAPETINGA;239;STC;CORTE;2022-08-11;9;9;0;5;N
BARREIRAS;20;EPS;RECORTE;2022-08-10;8;8;0;4;N
SANTO ANTONIO DE JESUS;428;EPS;CORTE;2022-08-09;10;10;0;3;N
JACOBINA;259;EPS;CORTE;2022-08-02;7;6;1;3;N
IBOTIRAMA;156;EPS;CORTE;2022-08-03;3;3;0;4;N
SANTA MARIA DA VITORIA;412;EPS;RECORTE;2022-08-17;2;1;1;4;N
VITORIA DA CONQUISTA;503;EPS;RECORTE;2022-08-25;16;13;3;5;N
FEIRA DE SANTANA NORTE;109;EPS;RECORTE;2022-08-17;6;5;1;4;N
ILHEUS;180;EPS;BAIXA;2022-08-17;10;10;0;4;N
TEIXEIRA DE FREITAS;471;EPS;BAIXA;2022-08-23;17;17;0;3;N
SANTO AMARO;422;EPS;DISJUNTOR;2022-08-19;4;4;0;6;N
CAMACARI;50;EPS;CORTE;2022-08-09;18;17;1;3;N
LIVRAMENTO DE NOSSA SENHORA;312;EPS;CORTE;2022-08-15;6;6;0;2;N
JEQUIE;275;EPS;CORTE;2022-08-09;22;21;1;3;N
VITORIA DA CONQUISTA;500;STC;CORTE;2022-08-25;11;11;0;5;N
BRUMADO;44;EPS;BAIXA;2022-08-04;4;3;1;5;N
IRECE;197;EPS;BAIXA;2022-08-17;5;5;0;4;N
ILHEUS;179;EPS;CORTE;2022-08-05;12;0;12;6;N
IRECE;196;EPS;CORTE;2022-08-05;7;0;7;6;N
FEIRA DE SANTANA SUL;123;STC;RECORTE;2022-08-24;23;22;1;4;N
ITAPETINGA;242;STC;RECORTE;2022-08-25;13;12;1;5;N
VALENCA;497;EPS;DISJUNTOR;2022-08-25;19;0;19;5;N
JUAZEIRO;290;EPS;CORTE;2022-08-08;40;39;1;2;N
AMARGOSA;10;EPS;CORTE;2022-08-02;7;7;0;3;N
JACOBINA;255;STC;CORTE;2022-08-15;19;19;0;2;N
AMARGOSA;11;STC;CORTE;2022-08-04;18;18;0;5;N
PERIPERI;347;EPS;CORTE;2022-08-12;30;28;2;6;N
VITORIA DA CONQUISTA;512;STC;CORTE;2022-08-04;5;5;0;5;N
IBOTIRAMA;167;STC;CORTE;2022-08-08;5;5;0;2;N
CANDEIAS;58;EPS;CORTE;2022-08-08;52;51;1;2;N
ITAPETINGA;247;EPS;CORTE;2022-08-24;11;11;0;4;N
BOM JESUS DA LAPA;33;STC;CORTE;2022-08-04;11;11;0;5;N
FEIRA DE SANTANA SUL;121;EPS;CORTE;2022-08-10;18;18;0;4;N
BRUMADO;46;STC;CORTE;2022-08-18;11;10;1;5;N
IRECE;192;EPS;CORTE;2022-08-04;11;11;0;5;N
EUNAPOLIS;86;STC;CORTE;2022-08-16;21;19;2;3;N
CONCEICAO DO COITE;68;EPS;RECORTE;2022-08-05;13;13;0;6;N
EUNAPOLIS;88;EPS;DISJUNTOR;2022-08-10;24;20;4;4;N
LAURO DE FREITAS;298;EPS;CORTE;2022-08-12;16;15;1;6;N
SENHOR DO BONFIM;446;EPS;CORTE;2022-08-23;10;9;1;3;N
SENHOR DO BONFIM;447;EPS;CORTE;2022-08-11;6;6;0;5;N
PIRAJA;352;EPS;CORTE;2022-08-04;14;14;0;5;N
LUIS EDUARDO MAGALHAES;317;STC;CORTE;2022-08-08;11;11;0;2;N
IRECE;192;STC;CORTE;2022-08-18;13;12;1;5;N
JEQUIE;275;EPS;RECORTE;2022-08-10;9;8;1;4;N
IRECE;197;STC;RECORTE;2022-08-08;16;15;1;2;N
ITABUNA;233;STC;CORTE;2022-08-22;18;17;1;2;N
PIRAJA;352;STC;CORTE;2022-08-18;17;16;1;5;N
FEIRA DE SANTANA NORTE;109;EPS;BAIXA;2022-08-17;7;7;0;4;N
VALENCA;487;EPS;RECORTE;2022-08-17;8;7;1;4;N
CONCEICAO DO COITE;63;EPS;CORTE;2022-08-15;6;6;0;2;N
JACOBINA;259;STC;RECORTE;2022-08-17;1;1;0;4;N
PIRAJA;351;EPS;CORTE;2022-08-16;15;13;2;3;N
CAMACARI;50;STC;RECORTE;2022-08-22;10;10;0;2;S
CONCEICAO DO COITE;68;STC;RECORTE;2022-08-19;11;10;1;6;N
ILHEUS;174;EPS;CORTE;2022-08-16;23;23;0;3;N
ITABERABA;221;EPS;CORTE;2022-08-15;4;4;0;2;N
PERIPERI;348;STC;CORTE;2022-08-12;10;10;0;6;S
BARREIRAS;13;STC;CORTE;2022-08-09;15;15;0;3;N
CONCEICAO DO COITE;65;STC;CORTE;2022-08-05;11;0;11;6;N
VALENCA;497;EPS;DISJUNTOR;2022-08-02;26;24;2;3;N
LAURO DE FREITAS;293;EPS;CORTE;2022-08-23;14;13;1;3;N
ILHEUS;186;STC;CORTE;2022-08-09;16;16;0;3;N
JUAZEIRO;287;STC;CORTE;2022-08-09;9;9;0;3;N
JUAZEIRO;285;EPS;CORTE;2022-08-19;13;12;1;6;N
PITUBA;358;EPS;RECORTE;2022-08-03;28;28;0;4;N
SANTO AMARO;424;STC;RECORTE;2022-08-02;9;2;7;3;S
FEIRA DE SANTANA NORTE;111;EPS;CORTE;2022-08-17;30;30;0;4;N
IBOTIRAMA;162;STC;CORTE;2022-08-19;12;12;0;6;N
FEIRA DE SANTANA NORTE;112;STC;CORTE;2022-08-19;21;20;1;6;N
CANDEIAS;58;STC;RECORTE;2022-08-23;16;11;5;3;N
JUAZEIRO;290;STC;RECORTE;2022-08-23;16;10;6;3;N
VALENCA;493;EPS;CORTE;2022-08-18;7;7;0;5;N
AMARGOSA;10;EPS;RECORTE;2022-08-03;5;5;0;4;N
BRUMADO;35;STC;CORTE;2022-08-04;11;11;0;5;N
SENHOR DO BONFIM;446;EPS;RECORTE;2022-08-24;11;9;2;4;N
ESPLANADA;81;EPS;CORTE;2022-08-09;15;14;1;3;N
IPIAU;531;EPS;BAIXA;2022-08-11;10;10;0;5;N
POSTO DA MATA;388;STC;RECORTE;2022-08-03;6;2;4;4;S
AMARGOSA;11;STC;RECORTE;2022-08-03;10;4;6;4;S
JACOBINA;257;EPS;BAIXA;2022-08-25;30;30;0;5;S
PAULO AFONSO;343;EPS;CORTE;2022-08-15;6;6;0;2;N
VITORIA DA CONQUISTA;520;EPS;CORTE;2022-08-17;15;15;0;4;N
JACOBINA;264;EPS;CORTE;2022-08-16;8;8;0;3;N
SANTO AMARO;421;EPS;DISJUNTOR;2022-08-08;3;3;0;2;N
SANTO ANTONIO DE JESUS;434;STC;CORTE;2022-08-25;19;18;1;5;N
PAULO AFONSO;329;STC;CORTE;2022-08-25;16;16;0;5;N
CAMACARI;56;STC;CORTE;2022-08-25;6;6;0;5;N
PIRAJA;353;STC;RECORTE;2022-08-05;14;4;10;6;S
PAULO AFONSO;328;EPS;CORTE;2022-08-23;8;8;0;3;N
FEIRA DE SANTANA NORTE;106;EPS;BAIXA;2022-08-04;8;7;1;5;N
PAULO AFONSO;335;STC;RECORTE;2022-08-03;1;1;0;4;N
PAULO AFONSO;345;STC;CORTE;2022-08-05;9;0;9;6;N
BARREIRAS;18;STC;CORTE;2022-08-23;42;37;5;3;N
ESPLANADA;77;EPS;CORTE;2022-08-08;16;16;0;2;N
ITAPOAN;253;STC;CORTE;2022-08-09;19;19;0;3;N
PIRAJA;352;EPS;BAIXA;2022-08-05;18;16;2;6;N
VALENCA;489;EPS;CORTE;2022-08-17;30;30;0;4;N
FEIRA DE SANTANA SUL;127;EPS;CORTE;2022-08-12;18;17;1;6;N
IBOTIRAMA;161;EPS;RECORTE;2022-08-18;4;4;0;5;N
SERRINHA;466;EPS;CORTE;2022-08-16;7;7;0;3;N
JEQUIE;278;STC;CORTE;2022-08-12;11;11;0;6;N
GUANAMBI;142;EPS;DISJUNTOR;2022-08-16;12;11;1;3;N
VALENCA;490;STC;CORTE;2022-08-19;17;17;0;6;N
AMARGOSA;6;STC;RECORTE;2022-08-16;18;17;1;3;N
VITORIA DA CONQUISTA;520;EPS;RECORTE;2022-08-18;16;15;1;5;N
VALENCA;495;STC;RECORTE;2022-08-09;17;13;4;3;N
IRECE;211;EPS;CORTE;2022-08-22;17;17;0;2;N
PAULO AFONSO;340;EPS;CORTE;2022-08-02;10;10;0;3;N
SERRINHA;459;EPS;BAIXA;2022-08-25;38;33;5;5;S
POSTO DA MATA;385;EPS;BAIXA;2022-08-25;15;15;0;5;S
IBOTIRAMA;163;STC;RECORTE;2022-08-08;11;8;3;2;N
JUAZEIRO;287;STC;RECORTE;2022-08-10;3;2;1;4;N
IPIAU;527;EPS;BAIXA;2022-08-10;5;3;2;4;N
ILHEUS;180;EPS;CORTE;2022-08-18;24;21;3;5;N
JACOBINA;262;STC;CORTE;2022-08-05;16;0;16;6;N
VALENCA;490;EPS;CORTE;2022-08-05;16;0;16;6;N
BRUMADO;44;EPS;CORTE;2022-08-05;5;0;5;6;N
VITORIA DA CONQUISTA;521;STC;RECORTE;2022-08-18;5;0;5;5;S
VITORIA DA CONQUISTA;509;EPS;BAIXA;2022-08-25;18;0;18;5;S
PORTO SEGURO;375;EPS;CORTE;2022-08-04;8;7;1;5;N
PIRAJA;354;STC;CORTE;2022-08-19;17;16;1;6;N
BARREIRAS;14;STC;CORTE;2022-08-22;16;16;0;2;N
SANTO ANTONIO DE JESUS;434;STC;CORTE;2022-08-02;19;18;1;3;N
ITAPOAN;251;EPS;RECORTE;2022-08-18;140;103;37;5;S
PITUBA;359;EPS;CORTE;2022-08-15;20;20;0;2;N
PAULO AFONSO;402;STC;CORTE;2022-08-08;11;11;0;2;N
VALENCA;491;STC;RECORTE;2022-08-08;17;17;0;2;N
ITABUNA;227;EPS;CORTE;2022-08-08;17;17;0;2;N
FEIRA DE SANTANA SUL;122;EPS;CORTE;2022-08-23;18;18;0;3;N
BOM JESUS DA LAPA;27;STC;CORTE;2022-08-04;11;11;0;5;N
GUANAMBI;150;EPS;CORTE;2022-08-11;7;7;0;5;N
EUNAPOLIS;92;EPS;RECORTE;2022-08-05;5;5;0;6;N
GRACA;133;EPS;CORTE;2022-08-15;21;21;0;2;N
FEIRA DE SANTANA NORTE;109;EPS;CORTE;2022-08-18;24;19;5;5;N
SENHOR DO BONFIM;454;STC;RECORTE;2022-08-16;17;16;1;3;N
SERRINHA;455;EPS;CORTE;2022-08-02;5;5;0;3;N
AMARGOSA;11;EPS;CORTE;2022-08-15;15;15;0;2;N
BRUMADO;40;STC;CORTE;2022-08-18;11;11;0;5;N
SANTO ANTONIO DE JESUS;9;EPS;CORTE;2022-08-12;10;10;0;6;N
SANTO AMARO;425;EPS;CORTE;2022-08-02;15;14;1;3;N
SEABRA;437;EPS;CORTE;2022-08-23;10;10;0;3;N
SANTO ANTONIO DE JESUS;432;EPS;CORTE;2022-08-12;5;4;1;6;N
GRACA;134;EPS;BAIXA;2022-08-25;15;13;2;5;S
TEIXEIRA DE FREITAS;473;STC;RECORTE;2022-08-15;17;16;1;2;N
ITAPETINGA;241;EPS;CORTE;2022-08-24;11;10;1;4;N
IBOTIRAMA;161;EPS;BAIXA;2022-08-18;1;1;0;5;N
SANTO ANTONIO DE JESUS;435;EPS;RECORTE;2022-08-24;1;1;0;4;S
ILHEUS;178;EPS;DISJUNTOR;2022-08-25;30;0;30;5;N
IPIAU;531;EPS;CORTE;2022-08-12;8;8;0;6;N
PAULO AFONSO;346;STC;CORTE;2022-08-18;16;15;1;5;N
FEIRA DE SANTANA NORTE;106;STC;CORTE;2022-08-19;22;21;1;6;N
GRACA;130;STC;CORTE;2022-08-16;34;30;4;3;N
TEIXEIRA DE FREITAS;479;STC;CORTE;2022-08-16;17;17;0;3;N
IRECE;204;STC;CORTE;2022-08-22;13;12;1;2;N
PORTO SEGURO;363;EPS;CORTE;2022-08-02;14;13;1;3;N
PITUBA;357;STC;CORTE;2022-08-04;19;17;2;5;N
GRACA;130;EPS;CORTE;2022-08-02;25;24;1;3;N
ALAGOINHAS;3;STC;CORTE;2022-08-15;12;12;0;2;N
VALENCA;497;STC;CORTE;2022-08-09;21;21;0;3;N
TEIXEIRA DE FREITAS;480;EPS;DISJUNTOR;2022-08-22;16;16;0;2;N
ITABERABA;213;STC;CORTE;2022-08-04;11;11;0;5;N
PITUBA;356;STC;CORTE;2022-08-16;38;37;1;3;N
LUIS EDUARDO MAGALHAES;320;STC;CORTE;2022-08-23;12;12;0;3;N
VALENCA;495;EPS;CORTE;2022-08-19;18;18;0;6;N
SANTO ANTONIO DE JESUS;428;EPS;CORTE;2022-08-11;10;9;1;5;N
PAULO AFONSO;345;EPS;CORTE;2022-08-16;8;8;0;3;N
VITORIA DA CONQUISTA;501;STC;CORTE;2022-08-15;11;10;1;2;N
RIBEIRA DO POMBAL;399;STC;CORTE;2022-08-12;11;11;0;6;N
LIVRAMENTO DE NOSSA SENHORA;303;EPS;RECORTE;2022-08-03;1;1;0;4;N
JACOBINA;258;EPS;CORTE;2022-08-16;8;7;1;3;N
IBOTIRAMA;155;EPS;CORTE;2022-08-17;14;14;0;4;N
SANTO ANTONIO DE JESUS;427;EPS;CORTE;2022-08-23;4;4;0;3;N
SANTO AMARO;423;EPS;DISJUNTOR;2022-08-09;4;4;0;3;N
ITAPETINGA;237;EPS;CORTE;2022-08-23;11;9;2;3;N
VALENCA;489;EPS;BAIXA;2022-08-18;17;14;3;5;N
ITABUNA;185;EPS;CORTE;2022-08-22;6;3;3;2;N
CONCEICAO DO COITE;62;EPS;BAIXA;2022-08-05;4;4;0;6;N
LUIS EDUARDO MAGALHAES;320;EPS;CORTE;2022-08-09;7;6;1;3;N
BRUMADO;37;STC;CORTE;2022-08-05;5;0;5;6;N
IBOTIRAMA;156;EPS;CORTE;2022-08-05;6;0;6;6;N
VITORIA DA CONQUISTA;515;EPS;CORTE;2022-08-05;15;0;15;6;N
IRECE;208;STC;RECORTE;2022-08-24;21;20;1;4;N
SANTO AMARO;419;EPS;CORTE;2022-08-25;30;0;30;5;N
POSTO DA MATA;386;EPS;CORTE;2022-08-16;7;6;1;3;N
ITABUNA;233;EPS;CORTE;2022-08-10;30;29;1;4;N
BOM JESUS DA LAPA;32;STC;CORTE;2022-08-18;8;7;1;5;N
GRACA;130;EPS;RECORTE;2022-08-03;19;19;0;4;N
GRACA;134;EPS;BAIXA;2022-08-04;11;10;1;5;N
PERIPERI;348;EPS;CORTE;2022-08-02;41;36;5;3;N
SERRINHA;464;EPS;RECORTE;2022-08-18;14;13;1;5;N
ILHEUS;178;EPS;DISJUNTOR;2022-08-02;31;30;1;3;N
JUAZEIRO;290;EPS;CORTE;2022-08-10;30;30;0;4;N
LIVRAMENTO DE NOSSA SENHORA;309;STC;CORTE;2022-08-18;10;10;0;5;N
CANDEIAS;58;EPS;CORTE;2022-08-10;38;36;2;4;N
IPIAU;530;STC;DISJUNTOR;2022-08-19;16;16;0;6;S
SANTO AMARO;421;STC;RECORTE;2022-08-16;13;10;3;3;N
ALAGOINHAS;3;STC;RECORTE;2022-08-16;9;4;5;3;N
LUIS EDUARDO MAGALHAES;320;EPS;RECORTE;2022-08-10;7;7;0;4;N
REMANSO;393;EPS;RECORTE;2022-08-24;65;62;3;4;N
PIRAJA;353;STC;CORTE;2022-08-08;17;16;1;2;N
PERIPERI;348;STC;CORTE;2022-08-16;16;16;0;3;N
LIVRAMENTO DE NOSSA SENHORA;309;EPS;CORTE;2022-08-04;6;6;0;5;N
SENHOR DO BONFIM;452;EPS;RECORTE;2022-08-03;7;7;0;4;N
LUIS EDUARDO MAGALHAES;316;STC;CORTE;2022-08-22;16;16;0;2;N
ITAPETINGA;239;STC;RECORTE;2022-08-12;18;12;6;6;S
SANTO ANTONIO DE JESUS;427;EPS;RECORTE;2022-08-24;8;7;1;4;N
IPIAU;188;EPS;RECORTE;2022-08-10;8;7;1;4;N
IBOTIRAMA;166;EPS;CORTE;2022-08-08;7;7;0;2;N
BRUMADO;45;EPS;CORTE;2022-08-18;7;6;1;5;N
CANDEIAS;59;STC;CORTE;2022-08-12;13;12;1;6;N
VITORIA DA CONQUISTA;525;EPS;CORTE;2022-08-08;8;7;1;2;N
PERIPERI;349;STC;CORTE;2022-08-04;6;6;0;5;N
PAULO AFONSO;334;EPS;CORTE;2022-08-02;7;6;1;3;N
POSTO DA MATA;387;EPS;CORTE;2022-08-04;18;17;1;5;N
ITABUNA;234;STC;CORTE;2022-08-12;16;16;0;6;N
TEIXEIRA DE FREITAS;479;STC;RECORTE;2022-08-17;17;13;4;4;N
PIRAJA;351;EPS;CORTE;2022-08-18;14;12;2;5;N
VITORIA DA CONQUISTA;503;EPS;BAIXA;2022-08-25;1;1;0;5;S
FEIRA DE SANTANA NORTE;116;EPS;CORTE;2022-08-08;11;9;2;2;N
RIBEIRA DO POMBAL;399;STC;RECORTE;2022-08-11;4;3;1;5;S
CONCEICAO DO COITE;64;STC;CORTE;2022-08-19;11;10;1;6;N
FEIRA DE SANTANA NORTE;107;STC;RECORTE;2022-08-08;15;13;2;2;N
ITAPETINGA;249;EPS;CORTE;2022-08-02;7;7;0;3;N
CONCEICAO DO COITE;63;EPS;CORTE;2022-08-17;7;6;1;4;N
IPIAU;526;EPS;CORTE;2022-08-23;6;6;0;3;N
PERIPERI;349;STC;CORTE;2022-08-02;5;5;0;3;S
JACOBINA;255;EPS;CORTE;2022-08-03;7;7;0;4;N
PORTO SEGURO;375;EPS;BAIXA;2022-08-05;1;1;0;6;N
GRACA;131;STC;RECORTE;2022-08-05;17;0;17;6;N
LUIS EDUARDO MAGALHAES;320;STC;RECORTE;2022-08-24;21;20;1;4;N
SERRINHA;456;EPS;CORTE;2022-08-15;12;12;0;2;N
VALENCA;494;EPS;CORTE;2022-08-08;10;10;0;2;N
SANTO AMARO;419;EPS;CORTE;2022-08-02;28;28;0;3;N
POSTO DA MATA;386;EPS;RECORTE;2022-08-17;6;6;0;4;N
JUAZEIRO;290;EPS;RECORTE;2022-08-11;40;40;0;5;N
PERIPERI;348;EPS;RECORTE;2022-08-03;18;18;0;4;N
AMARGOSA;5;EPS;CORTE;2022-08-15;10;9;1;2;N
ALAGOINHAS;1;EPS;CORTE;2022-08-02;33;32;1;3;N
JUAZEIRO;286;EPS;CORTE;2022-08-09;15;14;1;3;N
IBOTIRAMA;163;STC;CORTE;2022-08-09;9;9;0;3;N
EUNAPOLIS;85;EPS;RECORTE;2022-08-17;3;3;0;4;N
GRACA;135;EPS;CORTE;2022-08-16;21;17;4;3;N
ITABERABA;217;EPS;CORTE;2022-08-16;4;4;0;3;N
JACOBINA;534;EPS;CORTE;2022-08-15;8;8;0;2;N
ITABERABA;218;EPS;CORTE;2022-08-04;6;6;0;5;N
ITABUNA;230;STC;CORTE;2022-08-11;16;15;1;5;N
ITABERABA;218;STC;CORTE;2022-08-18;21;19;2;5;N
JUAZEIRO;290;STC;RECORTE;2022-08-23;6;2;4;3;S
CANDEIAS;58;EPS;RECORTE;2022-08-11;40;38;2;5;N
IBOTIRAMA;161;EPS;CORTE;2022-08-19;7;7;0;6;N
IRECE;193;STC;RECORTE;2022-08-09;17;16;1;3;N
CONCEICAO DO COITE;74;EPS;CORTE;2022-08-08;10;10;0;2;N
REMANSO;391;STC;RECORTE;2022-08-11;3;3;0;5;S
JACOBINA;255;EPS;RECORTE;2022-08-04;9;9;0;5;N
FEIRA DE SANTANA NORTE;113;STC;CORTE;2022-08-09;1;1;0;3;N
FEIRA DE SANTANA SUL;123;STC;RECORTE;2022-08-03;2;2;0;4;N
SENHOR DO BONFIM;448;STC;RECORTE;2022-08-16;11;11;0;3;N
PIRAJA;352;STC;RECORTE;2022-08-19;10;4;6;6;S
JUAZEIRO;287;STC;CORTE;2022-08-11;10;9;1;5;N
IRECE;203;STC;CORTE;2022-08-11;11;11;0;5;N
LAURO DE FREITAS;294;STC;CORTE;2022-08-25;20;20;0;5;S
IPIAU;526;EPS;RECORTE;2022-08-24;8;8;0;4;N
REMANSO;390;STC;RECORTE;2022-08-25;15;15;0;5;N
CANDEIAS;58;STC;RECORTE;2022-08-25;24;11;13;5;N
PAULO AFONSO;328;EPS;CORTE;2022-08-25;8;0;8;5;N
ITAPOAN;252;EPS;CORTE;2022-08-09;48;46;2;3;N
SANTO AMARO;419;EPS;RECORTE;2022-08-03;18;18;0;4;N
ITABERABA;217;EPS;RECORTE;2022-08-17;6;6;0;4;N
JACOBINA;260;EPS;CORTE;2022-08-17;8;8;0;4;N
ALAGOINHAS;1;EPS;RECORTE;2022-08-03;15;15;0;4;N
ITAPOAN;253;STC;CORTE;2022-08-11;19;17;2;5;N
FEIRA DE SANTANA SUL;128;EPS;CORTE;2022-08-02;18;17;1;3;N
JACOBINA;261;STC;CORTE;2022-08-19;32;32;0;6;N
SERRINHA;468;STC;CORTE;2022-08-08;11;11;0;2;N
IRECE;198;STC;CORTE;2022-08-22;17;17;0;2;N
PAULO AFONSO;327;STC;CORTE;2022-08-02;11;11;0;3;N
LAURO DE FREITAS;295;STC;RECORTE;2022-08-16;16;9;7;3;N
SENHOR DO BONFIM;453;EPS;CORTE;2022-08-15;6;6;0;2;N
PAULO AFONSO;340;EPS;CORTE;2022-08-04;8;8;0;5;N
ESPLANADA;78;STC;CORTE;2022-08-12;11;11;0;6;N
TEIXEIRA DE FREITAS;473;STC;CORTE;2022-08-16;17;17;0;3;N
ESPLANADA;80;EPS;RECORTE;2022-08-24;4;2;2;4;N
FEIRA DE SANTANA NORTE;113;STC;RECORTE;2022-08-10;1;1;0;4;N
TEIXEIRA DE FREITAS;477;STC;RECORTE;2022-08-16;19;18;1;3;S
IPIAU;526;EPS;BAIXA;2022-08-24;5;4;1;4;N
BARREIRAS;18;EPS;CORTE;2022-08-11;6;6;0;5;N
ALAGOINHAS;2;STC;RECORTE;2022-08-03;12;5;7;4;S
VITORIA DA CONQUISTA;500;STC;RECORTE;2022-08-03;9;8;1;4;S
VALENCA;495;STC;RECORTE;2022-08-09;6;4;2;3;S
ITAPETINGA;247;EPS;BAIXA;2022-08-25;16;16;0;5;S
GUANAMBI;142;EPS;DISJUNTOR;2022-08-18;15;14;1;5;N
IRECE;198;EPS;CORTE;2022-08-08;11;11;0;2;N
VALENCA;491;STC;CORTE;2022-08-09;17;17;0;3;N
GUANAMBI;139;EPS;CORTE;2022-08-22;5;5;0;2;N
BARREIRAS;18;STC;CORTE;2022-08-25;21;19;2;5;N
CAMACARI;51;EPS;CORTE;2022-08-24;19;15;4;4;N
IBOTIRAMA;171;EPS;CORTE;2022-08-22;3;3;0;2;N
JACOBINA;255;EPS;BAIXA;2022-08-04;5;5;0;5;N
SANTA MARIA DA VITORIA;417;EPS;CORTE;2022-08-09;8;8;0;3;N
PAULO AFONSO;325;EPS;CORTE;2022-08-12;8;6;2;6;N
IPIAU;189;EPS;CORTE;2022-08-22;7;7;0;2;N
IRECE;202;STC;RECORTE;2022-08-24;21;21;0;4;N
ITABUNA;229;STC;RECORTE;2022-08-24;16;16;0;4;N
IPIAU;532;EPS;CORTE;2022-08-25;7;0;7;5;N
ILHEUS;179;EPS;DISJUNTOR;2022-08-15;32;32;0;2;N
PIRAJA;353;EPS;CORTE;2022-08-19;42;39;3;6;N
BARREIRAS;20;STC;RECORTE;2022-08-02;15;11;4;3;N
IRECE;207;EPS;CORTE;2022-08-23;20;20;0;3;N
SANTO AMARO;424;EPS;CORTE;2022-08-16;22;22;0;3;N
PAULO AFONSO;401;STC;CORTE;2022-08-22;11;10;1;2;N
GRACA;136;EPS;BAIXA;2022-08-05;23;22;1;6;N
IRECE;195;STC;CORTE;2022-08-09;11;11;0;3;N
SANTO ANTONIO DE JESUS;433;EPS;CORTE;2022-08-02;6;4;2;3;N
IRECE;193;EPS;CORTE;2022-08-19;16;15;1;6;N
SANTA MARIA DA VITORIA;417;EPS;RECORTE;2022-08-10;5;4;1;4;N
ITABUNA;227;EPS;CORTE;2022-08-10;15;15;0;4;N
SANTA MARIA DA VITORIA;413;EPS;CORTE;2022-08-08;10;9;1;2;N
BARREIRAS;17;EPS;RECORTE;2022-08-24;5;5;0;4;N
LIVRAMENTO DE NOSSA SENHORA;305;EPS;BAIXA;2022-08-04;6;6;0;5;N
ITABERABA;217;EPS;BAIXA;2022-08-17;3;3;0;4;N
SERRINHA;456;EPS;BAIXA;2022-08-16;9;9;0;3;N
SENHOR DO BONFIM;450;STC;CORTE;2022-08-16;13;13;0;3;N
AMARGOSA;12;STC;CORTE;2022-08-19;16;16;0;6;N
SEABRA;444;STC;RECORTE;2022-08-03;3;1;2;4;S
ITAPOAN;252;STC;RECORTE;2022-08-24;140;123;17;4;N
ITAPOAN;252;STC;RECORTE;2022-08-22;49;33;16;2;S
PAULO AFONSO;340;STC;RECORTE;2022-08-19;11;6;5;6;N
PAULO AFONSO;340;EPS;RECORTE;2022-08-05;5;5;0;6;N
SERRINHA;463;STC;CORTE;2022-08-17;10;9;1;4;S
JUAZEIRO;291;EPS;CORTE;2022-08-23;15;14;1;3;N
JEQUIE;273;STC;CORTE;2022-08-25;11;9;2;5;N
EUNAPOLIS;102;EPS;CORTE;2022-08-09;6;5;1;3;N
AMARGOSA;6;EPS;BAIXA;2022-08-04;4;4;0;5;N
FEIRA DE SANTANA SUL;123;STC;CORTE;2022-08-25;8;8;0;5;S
PAULO AFONSO;337;STC;CORTE;2022-08-05;4;0;4;6;N
EUNAPOLIS;88;EPS;CORTE;2022-08-05;6;0;6;6;N
GRACA;134;EPS;CORTE;2022-08-05;10;0;10;6;N
FEIRA DE SANTANA SUL;128;STC;RECORTE;2022-08-17;1;1;0;4;N
GUANAMBI;149;EPS;CORTE;2022-08-25;4;0;4;5;N
ALAGOINHAS;2;EPS;CORTE;2022-08-15;29;29;0;2;N
EUNAPOLIS;98;STC;CORTE;2022-08-22;14;14;0;2;N
SANTO AMARO;422;STC;CORTE;2022-08-03;19;19;0;4;S
SANTO AMARO;424;EPS;RECORTE;2022-08-17;21;21;0;4;N
VITORIA DA CONQUISTA;500;EPS;CORTE;2022-08-15;15;15;0;2;N
ITABUNA;172;EPS;CORTE;2022-08-08;18;18;0;2;N
PITUBA;356;EPS;CORTE;2022-08-04;44;41;3;5;N
PITUBA;358;EPS;DISJUNTOR;2022-08-12;13;12;1;6;N
SENHOR DO BONFIM;454;EPS;BAIXA;2022-08-04;18;18;0;5;N
SANTO AMARO;420;EPS;CORTE;2022-08-15;11;11;0;2;N
GRACA;130;STC;CORTE;2022-08-18;17;16;1;5;N
PORTO SEGURO;376;STC;RECORTE;2022-08-09;21;4;17;3;N
ILHEUS;187;EPS;CORTE;2022-08-10;20;20;0;4;N
ESPLANADA;83;EPS;CORTE;2022-08-12;14;14;0;6;N
EUNAPOLIS;87;EPS;RECORTE;2022-08-18;3;3;0;5;N
IBOTIRAMA;164;STC;CORTE;2022-08-22;16;14;2;2;N
RIBEIRA DO POMBAL;400;STC;CORTE;2022-08-02;11;11;0;3;N
IRECE;205;STC;CORTE;2022-08-12;11;10;1;6;N
POSTO DA MATA;385;STC;CORTE;2022-08-18;16;16;0;5;N
SANTO AMARO;425;EPS;RECORTE;2022-08-05;26;26;0;6;N
GRACA;130;EPS;CORTE;2022-08-04;75;70;5;5;N
PITUBA;356;STC;CORTE;2022-08-18;38;35;3;5;N
SANTO AMARO;422;EPS;DISJUNTOR;2022-08-23;4;3;1;3;N
IPIAU;532;EPS;CORTE;2022-08-02;11;9;2;3;N
CONCEICAO DO COITE;68;EPS;CORTE;2022-08-08;10;9;1;2;N
SERRINHA;455;EPS;RECORTE;2022-08-05;10;10;0;6;N
ITAPETINGA;239;STC;CORTE;2022-08-15;9;9;0;2;N
JACOBINA;260;EPS;BAIXA;2022-08-18;5;5;0;5;N
LUIS EDUARDO MAGALHAES;320;EPS;CORTE;2022-08-11;7;7;0;5;N
PAULO AFONSO;345;EPS;CORTE;2022-08-18;8;7;1;5;N
JUAZEIRO;289;STC;CORTE;2022-08-12;9;9;0;6;N
FEIRA DE SANTANA SUL;126;EPS;BAIXA;2022-08-25;1;1;0;5;S
TEIXEIRA DE FREITAS;469;STC;RECORTE;2022-08-16;17;16;1;3;N
LUIS EDUARDO MAGALHAES;319;EPS;CORTE;2022-08-23;8;7;1;3;N
SANTO AMARO;423;EPS;DISJUNTOR;2022-08-11;3;3;0;5;N
ITABUNA;228;STC;RECORTE;2022-08-11;18;6;12;5;S
TEIXEIRA DE FREITAS;480;EPS;DISJUNTOR;2022-08-24;16;16;0;4;N
IRECE;203;EPS;CORTE;2022-08-22;5;5;0;2;N
IRECE;207;EPS;RECORTE;2022-08-24;13;12;1;4;N
BOM JESUS DA LAPA;23;STC;CORTE;2022-08-05;11;0;11;6;N
SANTO AMARO;422;STC;CORTE;2022-08-05;9;0;9;6;N
PIRAJA;352;EPS;CORTE;2022-08-08;57;53;4;2;N
PERIPERI;348;EPS;CORTE;2022-08-04;34;31;3;5;N
CANDEIAS;58;EPS;CORTE;2022-08-12;36;34;2;6;N
JACOBINA;255;STC;CORTE;2022-08-19;21;21;0;6;N
ITAPETINGA;248;EPS;CORTE;2022-08-16;12;11;1;3;N
REMANSO;390;EPS;CORTE;2022-08-12;8;7;1;6;N
SANTA MARIA DA VITORIA;536;EPS;CORTE;2022-08-04;8;7;1;5;N
ITABERABA;223;STC;CORTE;2022-08-09;11;10;1;3;N
BRUMADO;46;STC;CORTE;2022-08-22;11;11;0;2;N
ILHEUS;183;STC;CORTE;2022-08-23;19;19;0;3;N
CONCEICAO DO COITE;65;STC;CORTE;2022-08-09;11;10;1;3;N
ALAGOINHAS;3;STC;RECORTE;2022-08-16;20;8;12;3;S
IPIAU;532;EPS;RECORTE;2022-08-03;8;8;0;4;N
IRECE;192;EPS;CORTE;2022-08-08;7;7;0;2;N
LUIS EDUARDO MAGALHAES;317;STC;CORTE;2022-08-12;11;11;0;6;N
EUNAPOLIS;87;EPS;BAIXA;2022-08-18;2;1;1;5;N
RIBEIRA DO POMBAL;408;EPS;CORTE;2022-08-15;10;9;1;2;N
IRECE;200;STC;CORTE;2022-08-23;6;4;2;3;N
RIBEIRA DO POMBAL;409;EPS;CORTE;2022-08-03;10;10;0;4;N
PERIPERI;347;EPS;CORTE;2022-08-16;26;26;0;3;N
TEIXEIRA DE FREITAS;474;EPS;CORTE;2022-08-15;11;11;0;2;N
IBOTIRAMA;166;EPS;CORTE;2022-08-10;4;4;0;4;N
IRECE;207;EPS;BAIXA;2022-08-24;5;5;0;4;N
PITUBA;359;EPS;BAIXA;2022-08-18;16;14;2;5;N
SANTO ANTONIO DE JESUS;426;STC;CORTE;2022-08-02;13;13;0;3;N
ITABUNA;227;EPS;BAIXA;2022-08-11;14;2;12;5;N
CONCEICAO DO COITE;68;STC;RECORTE;2022-08-23;11;7;4;3;N
ALAGOINHAS;4;STC;RECORTE;2022-08-04;15;11;4;5;S
CONCEICAO DO COITE;63;EPS;CORTE;2022-08-19;7;7;0;6;N
JACOBINA;260;STC;RECORTE;2022-08-09;14;11;3;3;N
BRUMADO;46;EPS;CORTE;2022-08-08;7;7;0;2;N
ESPLANADA;79;STC;CORTE;2022-08-25;26;26;0;5;N
GUANAMBI;142;STC;CORTE;2022-08-25;21;20;1;5;N
CANDEIAS;59;STC;CORTE;2022-08-12;15;15;0;6;S
SANTA MARIA DA VITORIA;418;EPS;CORTE;2022-08-22;2;2;0;2;N
RIBEIRA DO POMBAL;410;STC;CORTE;2022-08-05;11;0;11;6;N
LUIS EDUARDO MAGALHAES;319;EPS;RECORTE;2022-08-24;4;4;0;4;N
JACOBINA;255;EPS;CORTE;2022-08-05;9;0;9;6;N
IPIAU;526;EPS;CORTE;2022-08-25;6;0;6;5;N
SANTA MARIA DA VITORIA;416;STC;CORTE;2022-08-11;11;11;0;5;N
SANTO ANTONIO DE JESUS;434;EPS;CORTE;2022-08-15;8;8;0;2;N
IRECE;193;STC;RECORTE;2022-08-11;196;195;1;5;N
REMANSO;389;EPS;RECORTE;2022-08-25;19;13;6;5;N
TEIXEIRA DE FREITAS;479;EPS;BAIXA;2022-08-05;16;14;2;6;N
JUAZEIRO;285;EPS;CORTE;2022-08-23;15;15;0;3;N
GRACA;135;EPS;CORTE;2022-08-18;84;78;6;5;N
PAULO AFONSO;333;EPS;RECORTE;2022-08-17;6;6;0;4;N
IBOTIRAMA;162;STC;CORTE;2022-08-23;9;9;0;3;N
LAURO DE FREITAS;294;EPS;CORTE;2022-08-15;16;16;0;2;N
ITABUNA;233;EPS;RECORTE;2022-08-11;12;10;2;5;S
CAMACARI;56;EPS;CORTE;2022-08-15;21;18;3;2;N
LAURO DE FREITAS;295;EPS;CORTE;2022-08-03;14;14;0;4;N
VITORIA DA CONQUISTA;521;EPS;CORTE;2022-08-09;15;15;0;3;N
SANTO AMARO;419;EPS;CORTE;2022-08-04;30;25;5;5;N
VITORIA DA CONQUISTA;507;STC;CORTE;2022-08-19;11;11;0;6;N
EUNAPOLIS;104;STC;CORTE;2022-08-22;24;19;5;2;S
ITABUNA;232;STC;DISJUNTOR;2022-08-19;16;16;0;6;S
VITORIA DA CONQUISTA;521;STC;CORTE;2022-08-23;11;11;0;3;N
RIBEIRA DO POMBAL;409;EPS;RECORTE;2022-08-04;7;7;0;5;N
SERRINHA;456;EPS;CORTE;2022-08-17;7;6;1;4;N
IRECE;204;EPS;BAIXA;2022-08-11;18;18;0;5;N
SANTO AMARO;421;EPS;BAIXA;2022-08-04;14;6;8;5;N
GRACA;130;EPS;BAIXA;2022-08-05;21;18;3;6;N
ITAPETINGA;244;EPS;CORTE;2022-08-15;12;11;1;2;N
IBOTIRAMA;162;EPS;CORTE;2022-08-09;4;4;0;3;N
JEQUIE;266;EPS;CORTE;2022-08-23;22;21;1;3;N
PIRAJA;353;STC;RECORTE;2022-08-11;17;17;0;5;N
PERIPERI;348;STC;RECORTE;2022-08-19;19;11;8;6;N
ITABERABA;217;EPS;CORTE;2022-08-18;3;3;0;5;N
ALAGOINHAS;3;EPS;BAIXA;2022-08-04;7;7;0;5;N
BRUMADO;44;EPS;DISJUNTOR;2022-08-15;5;5;0;2;N
SERRINHA;457;EPS;CORTE;2022-08-05;8;0;8;6;N
ITAPOAN;254;STC;RECORTE;2022-08-25;19;10;9;5;N
ITABUNA;233;STC;RECORTE;2022-08-25;9;5;4;5;S
JACOBINA;534;EPS;RECORTE;2022-08-18;9;9;0;5;N
LAURO DE FREITAS;295;EPS;RECORTE;2022-08-04;20;14;6;5;N
IRECE;198;STC;CORTE;2022-08-22;13;13;0;2;S
IRECE;197;EPS;CORTE;2022-08-22;16;16;0;2;N
VITORIA DA CONQUISTA;517;STC;CORTE;2022-08-22;11;11;0;2;N
GUANAMBI;142;STC;CORTE;2022-08-02;11;10;1;3;N
ESPLANADA;79;STC;CORTE;2022-08-02;26;25;1;3;N
ILHEUS;180;EPS;CORTE;2022-08-22;25;24;1;2;N
CAMACARI;53;STC;CORTE;2022-08-16;16;16;0;3;N
SENHOR DO BONFIM;454;STC;CORTE;2022-08-19;13;12;1;6;N
JACOBINA;262;STC;CORTE;2022-08-09;16;15;1;3;N
FEIRA DE SANTANA NORTE;112;EPS;RECORTE;2022-08-10;48;45;3;4;N
VALENCA;491;STC;CORTE;2022-08-11;17;17;0;5;N
FEIRA DE SANTANA NORTE;116;EPS;BAIXA;2022-08-11;17;13;4;5;N
SERRINHA;456;EPS;RECORTE;2022-08-18;7;7;0;5;N
ITABERABA;214;STC;CORTE;2022-08-19;21;21;0;6;N
JEQUIE;283;STC;RECORTE;2022-08-04;20;12;8;5;S
SANTO ANTONIO DE JESUS;431;STC;CORTE;2022-08-16;26;24;2;3;N
IRECE;199;STC;CORTE;2022-08-12;10;10;0;6;N
FEIRA DE SANTANA SUL;127;EPS;CORTE;2022-08-16;16;15;1;3;N
JACOBINA;260;EPS;CORTE;2022-08-19;8;7;1;6;N
ITABERABA;219;STC;RECORTE;2022-08-09;11;11;0;3;N
PORTO SEGURO;370;STC;RECORTE;2022-08-09;21;5;16;3;N
ESPLANADA;77;EPS;CORTE;2022-08-12;14;14;0;6;N
JEQUIE;279;STC;CORTE;2022-08-04;11;11;0;5;N
SENHOR DO BONFIM;448;EPS;BAIXA;2022-08-04;16;8;8;5;N
ESPLANADA;78;EPS;BAIXA;2022-08-24;2;2;0;4;N
PERIPERI;348;EPS;BAIXA;2022-08-05;8;4;4;6;N
PAULO AFONSO;341;STC;CORTE;2022-08-08;11;10;1;2;N
VITORIA DA CONQUISTA;519;EPS;DISJUNTOR;2022-08-16;25;24;1;3;N
ALAGOINHAS;1;EPS;RECORTE;2022-08-05;32;32;0;6;N
IRECE;203;STC;RECORTE;2022-08-12;15;9;6;6;S
POSTO DA MATA;379;EPS;CORTE;2022-08-04;9;8;1;5;N
IBOTIRAMA;171;EPS;CORTE;2022-08-24;6;6;0;4;N
LIVRAMENTO DE NOSSA SENHORA;306;STC;RECORTE;2022-08-08;11;11;0;2;N
SENHOR DO BONFIM;454;EPS;CORTE;2022-08-05;7;0;7;6;N
VALENCA;490;EPS;CORTE;2022-08-09;16;16;0;3;N
VITORIA DA CONQUISTA;521;STC;RECORTE;2022-08-24;11;10;1;4;N
FEIRA DE SANTANA NORTE;112;STC;RECORTE;2022-08-24;1;0;1;4;N
SENHOR DO BONFIM;450;STC;CORTE;2022-08-18;13;13;0;5;N
SANTA MARIA DA VITORIA;414;STC;CORTE;2022-08-12;11;9;2;6;N
IPIAU;526;EPS;RECORTE;2022-08-03;8;8;0;4;N
FEIRA DE SANTANA SUL;123;EPS;CORTE;2022-08-15;54;53;1;2;N
PIRAJA;354;EPS;CORTE;2022-08-09;34;32;2;3;N
LIVRAMENTO DE NOSSA SENHORA;312;STC;CORTE;2022-08-09;9;8;1;3;N
VALENCA;491;STC;RECORTE;2022-08-12;17;11;6;6;N
BARREIRAS;16;STC;CORTE;2022-08-02;15;13;2;3;N
JACOBINA;258;STC;CORTE;2022-08-08;16;15;1;2;N
SANTO ANTONIO DE JESUS;9;EPS;CORTE;2022-08-16;8;8;0;3;N
ITAPOAN;254;STC;RECORTE;2022-08-02;19;18;1;3;N
IRECE;209;STC;CORTE;2022-08-15;11;11;0;2;N
BRUMADO;44;EPS;RECORTE;2022-08-10;4;4;0;4;N
POSTO DA MATA;378;EPS;RECORTE;2022-08-17;12;12;0;4;N
SANTO AMARO;424;EPS;CORTE;2022-08-18;20;17;3;5;N
SEABRA;442;EPS;RECORTE;2022-08-17;3;3;0;4;N
AMARGOSA;11;EPS;CORTE;2022-08-19;20;20;0;6;N
PITUBA;359;EPS;CORTE;2022-08-19;18;18;0;6;N
SENHOR DO BONFIM;450;EPS;CORTE;2022-08-04;7;7;0;5;N
FEIRA DE SANTANA SUL;124;EPS;CORTE;2022-08-03;14;14;0;4;N
VITORIA DA CONQUISTA;520;EPS;BAIXA;2022-08-22;24;3;21;2;N
PORTO SEGURO;375;EPS;CORTE;2022-08-08;20;16;4;2;N
JACOBINA;262;STC;RECORTE;2022-08-10;3;3;0;4;N
VALENCA;490;EPS;RECORTE;2022-08-10;13;13;0;4;N
EUNAPOLIS;87;EPS;CORTE;2022-08-19;8;8;0;6;N
REMANSO;393;STC;CORTE;2022-08-15;9;9;0;2;N
JACOBINA;261;STC;RECORTE;2022-08-22;16;14;2;2;N
PORTO SEGURO;377;EPS;DISJUNTOR;2022-08-16;3;3;0;3;N
PIRAJA;354;STC;CORTE;2022-08-23;12;11;1;3;N
PORTO SEGURO;360;EPS;CORTE;2022-08-16;9;9;0;3;N
ILHEUS;177;EPS;CORTE;2022-08-09;6;6;0;3;N
IRECE;208;STC;CORTE;2022-08-25;6;6;0;5;S
IRECE;207;EPS;CORTE;2022-08-25;26;0;26;5;N
IRECE;204;EPS;CORTE;2022-08-12;13;13;0;6;N
PITUBA;359;EPS;DISJUNTOR;2022-08-02;26;25;1;3;N
PAULO AFONSO;332;STC;CORTE;2022-08-18;16;16;0;5;N
ESPLANADA;84;EPS;CORTE;2022-08-02;12;12;0;3;N
FEIRA DE SANTANA SUL;124;EPS;RECORTE;2022-08-04;48;45;3;5;N
RIBEIRA DO POMBAL;399;EPS;CORTE;2022-08-02;10;9;1;3;N
RIBEIRA DO POMBAL;400;STC;CORTE;2022-08-04;11;11;0;5;N
EUNAPOLIS;99;STC;CORTE;2022-08-12;14;14;0;6;N
CAMACARI;51;EPS;CORTE;2022-08-03;13;13;0;4;N
ITAPETINGA;238;EPS;CORTE;2022-08-15;12;12;0;2;N
PITUBA;357;STC;CORTE;2022-08-08;19;17;2;2;N
PIRAJA;353;EPS;DISJUNTOR;2022-08-04;20;20;0;5;N
EUNAPOLIS;87;EPS;DISJUNTOR;2022-08-02;11;10;1;3;N
JUAZEIRO;288;EPS;CORTE;2022-08-12;15;14;1;6;N
ALAGOINHAS;3;STC;CORTE;2022-08-19;2;2;0;6;N
SANTO AMARO;421;STC;CORTE;2022-08-19;21;20;1;6;N
IBOTIRAMA;165;STC;CORTE;2022-08-12;9;9;0;6;N
GRACA;129;EPS;CORTE;2022-08-18;21;19;2;5;N
SANTO AMARO;421;STC;CORTE;2022-08-17;20;19;1;4;S
ITAPETINGA;239;EPS;CORTE;2022-08-03;9;9;0;4;N
VALENCA;495;EPS;CORTE;2022-08-23;32;32;0;3;N
IPIAU;532;EPS;CORTE;2022-08-04;11;11;0;5;N
LAURO DE FREITAS;297;STC;CORTE;2022-08-18;16;15;1;5;N
CONCEICAO DO COITE;68;EPS;CORTE;2022-08-10;7;7;0;4;N
IRECE;205;STC;CORTE;2022-08-12;15;15;0;6;S
SANTO ANTONIO DE JESUS;9;EPS;RECORTE;2022-08-17;6;6;0;4;N
RIBEIRA DO POMBAL;399;STC;CORTE;2022-08-16;11;11;0;3;N
VITORIA DA CONQUISTA;506;STC;RECORTE;2022-08-09;11;5;6;3;N
PAULO AFONSO;324;EPS;BAIXA;2022-08-25;12;9;3;5;S
GRACA;131;EPS;BAIXA;2022-08-18;3;3;0;5;N
PORTO SEGURO;370;EPS;CORTE;2022-08-19;10;10;0;6;N
IPIAU;531;EPS;CORTE;2022-08-16;8;8;0;3;N
SANTO ANTONIO DE JESUS;428;EPS;CORTE;2022-08-15;8;8;0;2;N
ITABUNA;229;STC;RECORTE;2022-08-03;16;16;0;4;N
SANTO ANTONIO DE JESUS;432;EPS;RECORTE;2022-08-17;6;3;3;4;N
VALENCA;486;STC;RECORTE;2022-08-23;17;17;0;3;N
JUAZEIRO;287;EPS;CORTE;2022-08-24;11;11;0;4;N
FEIRA DE SANTANA NORTE;106;EPS;CORTE;2022-08-09;54;53;1;3;N
SANTO AMARO;421;EPS;CORTE;2022-08-05;15;0;15;6;N
ALAGOINHAS;3;EPS;CORTE;2022-08-05;12;0;12;6;N
FEIRA DE SANTANA SUL;121;STC;CORTE;2022-08-04;1;1;0;5;N
SANTO AMARO;422;EPS;DISJUNTOR;2022-08-25;27;0;27;5;N
VALENCA;491;EPS;CORTE;2022-08-22;24;23;1;2;N
FEIRA DE SANTANA NORTE;106;EPS;RECORTE;2022-08-10;64;62;2;4;N
REMANSO;391;EPS;CORTE;2022-08-02;28;25;3;3;N
ITABUNA;234;STC;CORTE;2022-08-16;16;16;0;3;N
CANDEIAS;59;EPS;CORTE;2022-08-02;16;16;0;3;N
ITAPETINGA;239;EPS;RECORTE;2022-08-04;9;8;1;5;N
BARREIRAS;17;EPS;RECORTE;2022-08-03;8;8;0;4;N
REMANSO;392;STC;CORTE;2022-08-02;12;11;1;3;S
LIVRAMENTO DE NOSSA SENHORA;309;EPS;CORTE;2022-08-08;5;4;1;2;N
CONCEICAO DO COITE;64;STC;CORTE;2022-08-23;11;9;2;3;N
ITAPOAN;254;EPS;CORTE;2022-08-12;23;23;0;6;N
PAULO AFONSO;341;EPS;CORTE;2022-08-19;8;8;0;6;N
FEIRA DE SANTANA NORTE;116;EPS;CORTE;2022-08-12;40;39;1;6;N
GUANAMBI;151;EPS;BAIXA;2022-08-04;10;3;7;5;N
VITORIA DA CONQUISTA;500;EPS;RECORTE;2022-08-18;16;13;3;5;N
CONCEICAO DO COITE;65;STC;CORTE;2022-08-11;11;11;0;5;N
SANTO ANTONIO DE JESUS;429;STC;RECORTE;2022-08-18;20;18;2;5;N
CONCEICAO DO COITE;68;EPS;RECORTE;2022-08-11;5;4;1;5;N
VALENCA;495;EPS;RECORTE;2022-08-24;11;9;2;4;N
PITUBA;357;STC;RECORTE;2022-08-09;42;21;21;3;N
GRACA;131;STC;RECORTE;2022-08-09;17;6;11;3;N
PERIPERI;347;EPS;CORTE;2022-08-18;24;22;2;5;N
FEIRA DE SANTANA SUL;123;EPS;BAIXA;2022-08-16;20;19;1;3;N
RIBEIRA DO POMBAL;399;STC;RECORTE;2022-08-17;11;9;2;4;N
BRUMADO;46;STC;CORTE;2022-08-22;10;9;1;2;S
CAMACARI;51;STC;RECORTE;2022-08-16;6;3;3;3;S
SANTO AMARO;419;EPS;DISJUNTOR;2022-08-12;3;3;0;6;N
BRUMADO;47;STC;CORTE;2022-08-12;11;9;2;6;N
JUAZEIRO;284;STC;CORTE;2022-08-25;14;13;1;5;N
ILHEUS;182;EPS;CORTE;2022-08-23;12;11;1;3;N
SANTA MARIA DA VITORIA;535;EPS;CORTE;2022-08-18;2;2;0;5;N
PAULO AFONSO;407;EPS;CORTE;2022-08-12;7;7;0;6;N
FEIRA DE SANTANA SUL;124;EPS;BAIXA;2022-08-04;21;14;7;5;N
ITABERABA;222;EPS;CORTE;2022-08-09;5;5;0;3;N
BRUMADO;49;EPS;RECORTE;2022-08-24;2;1;1;4;N
TEIXEIRA DE FREITAS;475;EPS;CORTE;2022-08-05;13;0;13;6;N
RIBEIRA DO POMBAL;409;EPS;CORTE;2022-08-05;13;0;13;6;N
ESPLANADA;78;EPS;CORTE;2022-08-25;14;0;14;5;N
PAULO AFONSO;402;EPS;CORTE;2022-08-23;8;8;0;3;N
ITABERABA;218;STC;CORTE;2022-08-22;10;10;0;2;N
BRUMADO;42;STC;CORTE;2022-08-23;11;11;0;3;N
BOM JESUS DA LAPA;29;STC;CORTE;2022-08-09;11;10;1;3;N
ITABUNA;233;EPS;RECORTE;2022-08-15;11;7;4;2;N
ITABUNA;234;EPS;RECORTE;2022-08-03;6;6;0;4;N
ITAPOAN;252;EPS;DISJUNTOR;2022-08-19;32;32;0;6;N
REMANSO;391;EPS;RECORTE;2022-08-03;16;14;2;4;N
SEABRA;441;STC;CORTE;2022-08-18;21;20;1;5;N
GRACA;136;EPS;CORTE;2022-08-08;18;17;1;2;N
ITABUNA;230;STC;CORTE;2022-08-15;16;14;2;2;N
TEIXEIRA DE FREITAS;471;STC;CORTE;2022-08-18;19;18;1;5;N
SERRINHA;456;EPS;CORTE;2022-08-19;7;7;0;6;N
VITORIA DA CONQUISTA;520;EPS;CORTE;2022-08-23;15;14;1;3;N
CAMACARI;57;STC;CORTE;2022-08-17;5;5;0;4;S
TEIXEIRA DE FREITAS;485;EPS;CORTE;2022-08-08;13;13;0;2;N
ITAPETINGA;239;EPS;BAIXA;2022-08-04;9;7;2;5;N
PERIPERI;348;STC;RECORTE;2022-08-19;8;6;2;6;S
PERIPERI;349;STC;RECORTE;2022-08-09;38;24;14;3;N
IRECE;211;STC;CORTE;2022-08-16;11;11;0;3;N
ITAPOAN;250;STC;CORTE;2022-08-25;19;19;0;5;N
FEIRA DE SANTANA NORTE;112;STC;CORTE;2022-08-25;19;19;0;5;N
SANTA MARIA DA VITORIA;415;STC;CORTE;2022-08-25;9;9;0;5;N
ITABUNA;229;STC;CORTE;2022-08-25;5;5;0;5;S
JEQUIE;273;STC;RECORTE;2022-08-03;6;6;0;4;S
SANTA MARIA DA VITORIA;414;EPS;CORTE;2022-08-23;2;2;0;3;N
ITAPETINGA;245;EPS;CORTE;2022-08-05;14;0;14;6;N
CAMACARI;57;EPS;CORTE;2022-08-05;8;0;8;6;N
ITABUNA;228;EPS;CORTE;2022-08-25;25;0;25;5;N
PAULO AFONSO;340;EPS;CORTE;2022-08-08;10;10;0;2;N
JACOBINA;261;STC;CORTE;2022-08-23;18;18;0;3;N
SANTO ANTONIO DE JESUS;431;STC;CORTE;2022-08-18;13;13;0;5;N
SERRINHA;468;STC;CORTE;2022-08-12;11;11;0;6;N
LUIS EDUARDO MAGALHAES;323;STC;CORTE;2022-08-16;22;21;1;3;N
GUANAMBI;142;STC;CORTE;2022-08-02;41;40;1;3;S
JUAZEIRO;284;STC;CORTE;2022-08-02;3;3;0;3;N
CAMACARI;52;EPS;CORTE;2022-08-16;21;19;2;3;N
LAURO DE FREITAS;294;EPS;RECORTE;2022-08-18;33;29;4;5;N
JEQUIE;277;EPS;CORTE;2022-08-16;20;17;3;3;N
ESPLANADA;78;EPS;CORTE;2022-08-02;16;15;1;3;N
SENHOR DO BONFIM;453;EPS;CORTE;2022-08-19;10;10;0;6;N
ITAPETINGA;241;STC;CORTE;2022-08-18;9;9;0;5;N
LAURO DE FREITAS;293;EPS;DISJUNTOR;2022-08-12;34;32;2;6;N
JEQUIE;265;STC;CORTE;2022-08-02;5;5;0;3;N
JEQUIE;278;EPS;CORTE;2022-08-04;16;16;0;5;N
VITORIA DA CONQUISTA;518;STC;CORTE;2022-08-12;11;10;1;6;N
ESPLANADA;79;STC;CORTE;2022-08-04;13;13;0;5;N
GRACA;133;STC;CORTE;2022-08-09;17;16;1;3;N
FEIRA DE SANTANA NORTE;107;EPS;CORTE;2022-08-22;42;40;2;2;N
GRACA;131;EPS;CORTE;2022-08-19;21;20;1;6;N
SERRINHA;467;EPS;CORTE;2022-08-10;10;8;2;4;N
FEIRA DE SANTANA NORTE;109;STC;CORTE;2022-08-10;21;21;0;4;S
VITORIA DA CONQUISTA;504;STC;CORTE;2022-08-08;11;11;0;2;N
PAULO AFONSO;326;STC;CORTE;2022-08-18;16;15;1;5;N
JACOBINA;262;STC;CORTE;2022-08-11;16;16;0;5;N
ITABERABA;213;EPS;CORTE;2022-08-19;3;3;0;6;N
IRECE;198;EPS;CORTE;2022-08-12;13;12;1;6;N
JACOBINA;261;EPS;CORTE;2022-08-09;9;9;0;3;N
PAULO AFONSO;325;EPS;CORTE;2022-08-16;8;7;1;3;N
IRECE;199;EPS;BAIXA;2022-08-24;2;1;1;4;N
GRACA;137;STC;RECORTE;2022-08-09;10;3;7;3;S
LIVRAMENTO DE NOSSA SENHORA;306;STC;RECORTE;2022-08-10;4;3;1;4;N
VALENCA;490;EPS;CORTE;2022-08-11;14;13;1;5;N
VITORIA DA CONQUISTA;516;EPS;CORTE;2022-08-22;6;6;0;2;N
POSTO DA MATA;378;EPS;CORTE;2022-08-18;7;7;0;5;N
ILHEUS;181;EPS;CORTE;2022-08-12;14;14;0;6;N
FEIRA DE SANTANA NORTE;111;EPS;RECORTE;2022-08-24;8;8;0;4;N
FEIRA DE SANTANA NORTE;109;STC;CORTE;2022-08-12;1;1;0;6;N
FEIRA DE SANTANA SUL;123;EPS;CORTE;2022-08-17;54;54;0;4;N
PIRAJA;353;EPS;CORTE;2022-08-23;13;12;1;3;N
BARREIRAS;16;STC;CORTE;2022-08-04;15;14;1;5;N
JUAZEIRO;292;EPS;CORTE;2022-08-15;15;15;0;2;N
IRECE;193;EPS;CORTE;2022-08-23;80;76;4;3;N
IPIAU;530;STC;CORTE;2022-08-18;13;13;0;5;N
LUIS EDUARDO MAGALHAES;319;STC;CORTE;2022-08-15;11;11;0;2;N
LIVRAMENTO DE NOSSA SENHORA;312;STC;CORTE;2022-08-11;9;9;0;5;N
ITAPOAN;250;STC;CORTE;2022-08-02;10;9;1;3;N
ESPLANADA;78;EPS;RECORTE;2022-08-03;18;17;1;4;N
FEIRA DE SANTANA SUL;124;STC;CORTE;2022-08-19;22;19;3;6;N
ILHEUS;180;STC;DISJUNTOR;2022-08-19;10;10;0;6;S
JACOBINA;257;STC;CORTE;2022-08-22;16;16;0;2;N
PIRAJA;354;EPS;CORTE;2022-08-11;16;14;2;5;N
SENHOR DO BONFIM;449;EPS;CORTE;2022-08-18;10;10;0;5;N
SEABRA;440;STC;CORTE;2022-08-05;14;14;0;6;S
VITORIA DA CONQUISTA;513;STC;CORTE;2022-08-23;11;11;0;3;N
SERRINHA;464;STC;CORTE;2022-08-11;11;11;0;5;N
PERIPERI;349;EPS;CORTE;2022-08-19;11;10;1;6;N
IRECE;194;EPS;CORTE;2022-08-11;13;13;0;5;N
CAMACARI;50;EPS;DISJUNTOR;2022-08-23;35;34;1;3;N
VALENCA;489;EPS;RECORTE;2022-08-24;12;11;1;4;N
SEABRA;444;STC;RECORTE;2022-08-09;11;6;5;3;N
AMARGOSA;12;STC;CORTE;2022-08-23;16;16;0;3;N
RIBEIRA DO POMBAL;404;EPS;BAIXA;2022-08-17;10;8;2;4;N
FEIRA DE SANTANA NORTE;111;EPS;BAIXA;2022-08-24;6;6;0;4;N
PORTO SEGURO;360;EPS;CORTE;2022-08-18;10;10;0;5;N
BARREIRAS;15;STC;CORTE;2022-08-16;15;15;0;3;N
EUNAPOLIS;88;EPS;CORTE;2022-08-09;12;12;0;3;N
SERRINHA;467;STC;RECORTE;2022-08-23;4;4;0;3;S
PAULO AFONSO;325;EPS;RECORTE;2022-08-17;5;5;0;4;N
AMARGOSA;12;EPS;CORTE;2022-08-09;6;6;0;3;N
ITAPOAN;254;STC;RECORTE;2022-08-04;19;18;1;5;N
PIRAJA;354;STC;CORTE;2022-08-25;17;16;1;5;N
SERRINHA;463;EPS;CORTE;2022-08-09;6;6;0;3;N
LIVRAMENTO DE NOSSA SENHORA;311;EPS;CORTE;2022-08-09;5;5;0;3;N
GUANAMBI;142;STC;RECORTE;2022-08-05;13;0;13;6;N
REMANSO;394;STC;CORTE;2022-08-05;9;0;9;6;N
FEIRA DE SANTANA SUL;124;EPS;CORTE;2022-08-05;23;0;23;6;N
SEABRA;439;EPS;CORTE;2022-08-05;5;0;5;6;N
TEIXEIRA DE FREITAS;469;EPS;CORTE;2022-08-05;13;0;13;6;N
SANTO AMARO;425;EPS;CORTE;2022-08-08;15;15;0;2;N
SERRINHA;467;STC;RECORTE;2022-08-25;11;5;6;5;N
GRACA;135;EPS;BAIXA;2022-08-19;39;0;39;6;S
GRACA;130;EPS;CORTE;2022-08-08;81;77;4;2;N
CANDEIAS;58;EPS;DISJUNTOR;2022-08-22;27;27;0;2;N
LAURO DE FREITAS;298;STC;CORTE;2022-08-08;16;16;0;2;N
POSTO DA MATA;385;EPS;CORTE;2022-08-08;18;17;1;2;N
PITUBA;356;EPS;CORTE;2022-08-08;81;80;1;2;N
SANTO AMARO;423;EPS;DISJUNTOR;2022-08-15;9;9;0;2;N
ITAPOAN;250;STC;RECORTE;2022-08-03;19;18;1;4;N
JEQUIE;270;STC;CORTE;2022-08-16;11;10;1;3;N
ESPLANADA;83;EPS;CORTE;2022-08-16;13;10;3;3;N
PITUBA;356;STC;CORTE;2022-08-22;38;36;2;2;N
ALAGOINHAS;2;EPS;CORTE;2022-08-19;30;29;1;6;N
SANTO AMARO;422;STC;CORTE;2022-08-09;9;9;0;3;N
BOM JESUS DA LAPA;23;STC;CORTE;2022-08-09;11;11;0;3;N
VITORIA DA CONQUISTA;502;STC;CORTE;2022-08-09;11;11;0;3;N
FEIRA DE SANTANA SUL;123;EPS;RECORTE;2022-08-18;42;38;4;5;N
IRECE;205;STC;CORTE;2022-08-16;11;11;0;3;N
IBOTIRAMA;166;STC;CORTE;2022-08-02;6;6;0;3;N
ITABUNA;172;EPS;CORTE;2022-08-12;17;17;0;6;N
PORTO SEGURO;371;EPS;CORTE;2022-08-09;8;8;0;3;N
PITUBA;358;EPS;DISJUNTOR;2022-08-16;13;13;0;3;N
EUNAPOLIS;88;EPS;RECORTE;2022-08-10;3;3;0;4;N
BRUMADO;36;STC;CORTE;2022-08-23;9;8;1;3;N
IRECE;206;STC;CORTE;2022-08-04;11;11;0;5;N
TEIXEIRA DE FREITAS;479;EPS;CORTE;2022-08-08;14;14;0;2;N
GUANAMBI;147;EPS;CORTE;2022-08-04;7;6;1;5;N
SERRINHA;459;STC;CORTE;2022-08-22;11;11;0;2;N
BRUMADO;37;STC;CORTE;2022-08-11;11;11;0;5;N
JUAZEIRO;289;EPS;CORTE;2022-08-02;13;12;1;3;N
SANTO AMARO;420;EPS;CORTE;2022-08-19;10;10;0;6;N
PORTO SEGURO;371;STC;CORTE;2022-08-23;16;14;2;3;N
SERRINHA;464;STC;RECORTE;2022-08-12;9;4;5;6;N
IRECE;193;EPS;RECORTE;2022-08-24;45;45;0;4;N
ILHEUS;173;EPS;CORTE;2022-08-10;20;19;1;4;N
PITUBA;359;EPS;DISJUNTOR;2022-08-04;10;10;0;5;N
ITABERABA;223;EPS;RECORTE;2022-08-23;1;1;0;3;N
IBOTIRAMA;169;STC;RECORTE;2022-08-16;11;10;1;3;N
FEIRA DE SANTANA NORTE;108;EPS;BAIXA;2022-08-11;17;17;0;5;N
IRECE;209;STC;RECORTE;2022-08-16;10;10;0;3;S
PAULO AFONSO;345;EPS;CORTE;2022-08-22;4;4;0;2;N
CAMACARI;53;EPS;BAIXA;2022-08-05;12;11;1;6;N
JUAZEIRO;290;STC;CORTE;2022-08-04;2;2;0;5;N
BRUMADO;36;EPS;CORTE;2022-08-09;5;5;0;3;N
SANTO ANTONIO DE JESUS;430;STC;CORTE;2022-08-05;4;4;0;6;S
PAULO AFONSO;336;EPS;RECORTE;2022-08-08;1;0;1;2;N
VALENCA;495;EPS;CORTE;2022-08-25;32;0;32;5;N
PERIPERI;348;EPS;CORTE;2022-08-08;38;37;1;2;N
REMANSO;391;EPS;CORTE;2022-08-04;11;11;0;5;N
IRECE;205;EPS;RECORTE;2022-08-03;6;6;0;4;N
IRECE;205;STC;RECORTE;2022-08-17;21;18;3;4;N
BARREIRAS;21;STC;CORTE;2022-08-18;20;20;0;5;N
LUIS EDUARDO MAGALHAES;317;EPS;CORTE;2022-08-02;9;8;1;3;N
ESPLANADA;83;EPS;RECORTE;2022-08-17;10;10;0;4;N
LUIS EDUARDO MAGALHAES;317;STC;CORTE;2022-08-16;22;21;1;3;N
BOM JESUS DA LAPA;33;STC;CORTE;2022-08-10;20;20;0;4;S
PORTO SEGURO;370;EPS;DISJUNTOR;2022-08-04;24;24;0;5;N
JUAZEIRO;285;STC;CORTE;2022-08-15;14;13;1;2;N
JACOBINA;255;EPS;CORTE;2022-08-09;9;9;0;3;N
LAURO DE FREITAS;293;STC;CORTE;2022-08-19;16;16;0;6;N
PAULO AFONSO;328;STC;CORTE;2022-08-19;11;11;0;6;N
ALAGOINHAS;3;STC;RECORTE;2022-08-22;16;14;2;2;N
EUNAPOLIS;93;EPS;CORTE;2022-08-23;14;14;0;3;N
VALENCA;494;STC;CORTE;2022-08-02;22;22;0;3;N
LAURO DE FREITAS;298;STC;RECORTE;2022-08-09;16;12;4;3;N
SERRINHA;468;EPS;CORTE;2022-08-23;6;6;0;3;N
RIBEIRA DO POMBAL;408;EPS;CORTE;2022-08-19;8;8;0;6;N
IRECE;193;EPS;BAIXA;2022-08-24;13;9;4;4;N
LUIS EDUARDO MAGALHAES;318;STC;CORTE;2022-08-04;11;10;1;5;N
PITUBA;357;STC;RECORTE;2022-08-09;9;5;4;3;S
PITUBA;357;STC;RECORTE;2022-08-11;21;19;2;5;N
VALENCA;492;EPS;CORTE;2022-08-12;14;14;0;6;N
GUANAMBI;142;EPS;CORTE;2022-08-15;5;5;0;2;N
LAURO DE FREITAS;297;STC;RECORTE;2022-08-19;9;8;1;6;S
PITUBA;356;STC;RECORTE;2022-08-23;17;11;6;3;N
EUNAPOLIS;99;STC;RECORTE;2022-08-15;16;15;1;2;N
FEIRA DE SANTANA SUL;123;EPS;BAIXA;2022-08-18;18;14;4;5;N
EUNAPOLIS;88;EPS;BAIXA;2022-08-10;2;2;0;4;N
CONCEICAO DO COITE;63;EPS;CORTE;2022-08-23;7;5;2;3;N
EUNAPOLIS;97;EPS;RECORTE;2022-08-25;3;1;2;5;N
JUAZEIRO;290;STC;RECORTE;2022-08-05;16;0;16;6;N
ITABUNA;229;EPS;CORTE;2022-08-15;14;14;0;2;N
SANTA MARIA DA VITORIA;416;STC;CORTE;2022-08-15;11;11;0;2;N
VITORIA DA CONQUISTA;507;STC;CORTE;2022-08-23;11;11;0;3;N
RIBEIRA DO POMBAL;406;STC;CORTE;2022-08-08;11;11;0;2;N
IRECE;210;EPS;CORTE;2022-08-16;9;9;0;3;N
ITABERABA;217;EPS;CORTE;2022-08-22;4;4;0;2;N
CONCEICAO DO COITE;75;EPS;CORTE;2022-08-02;6;6;0;3;N
GRACA;135;EPS;CORTE;2022-08-22;83;83;0;2;N
IRECE;211;STC;CORTE;2022-08-18;21;19;2;5;N
ITABUNA;233;EPS;RECORTE;2022-08-17;8;8;0;4;N
JUAZEIRO;287;EPS;CORTE;2022-08-03;10;9;1;4;N
LUIS EDUARDO MAGALHAES;317;EPS;RECORTE;2022-08-03;7;5;2;4;N
GRACA;137;STC;CORTE;2022-08-12;17;17;0;6;N
BOM JESUS DA LAPA;29;STC;CORTE;2022-08-11;11;11;0;5;N
SANTO ANTONIO DE JESUS;434;EPS;CORTE;2022-08-19;8;7;1;6;N
ITAPETINGA;244;EPS;CORTE;2022-08-19;12;11;1;6;N
PORTO SEGURO;376;EPS;CORTE;2022-08-23;18;17;1;3;N
ITABERABA;219;STC;CORTE;2022-08-12;11;11;0;6;N
REMANSO;390;EPS;RECORTE;2022-08-17;4;4;0;4;N
BOM JESUS DA LAPA;28;EPS;CORTE;2022-08-09;5;5;0;3;N
PIRAJA;350;EPS;BAIXA;2022-08-11;20;16;4;5;N
RIBEIRA DO POMBAL;399;EPS;BAIXA;2022-08-05;16;12;4;6;N
BOM JESUS DA LAPA;28;STC;CORTE;2022-08-23;15;13;2;3;N
REMANSO;392;STC;RECORTE;2022-08-05;6;6;0;6;S
FEIRA DE SANTANA NORTE;113;STC;CORTE;2022-08-15;2;2;0;2;N
SANTO ANTONIO DE JESUS;426;STC;RECORTE;2022-08-05;7;3;4;6;S
RIBEIRA DO POMBAL;410;STC;RECORTE;2022-08-10;4;4;0;4;N
LIVRAMENTO DE NOSSA SENHORA;310;STC;RECORTE;2022-08-11;15;14;1;5;S
PERIPERI;349;STC;RECORTE;2022-08-09;11;6;5;3;S
SEABRA;442;STC;CORTE;2022-08-08;5;5;0;2;N
ESPLANADA;83;EPS;BAIXA;2022-08-17;6;6;0;4;N
ITABUNA;231;STC;CORTE;2022-08-05;16;0;16;6;N
JEQUIE;269;STC;CORTE;2022-08-05;11;0;11;6;N
ILHEUS;186;EPS;BAIXA;2022-08-25;19;0;19;5;S
SANTA MARIA DA VITORIA;414;EPS;CORTE;2022-08-25;2;0;2;5;N
ILHEUS;182;EPS;CORTE;2022-08-02;13;13;0;3;N
BOM JESUS DA LAPA;24;STC;CORTE;2022-08-22;14;14;0;2;N
LUIS EDUARDO MAGALHAES;323;STC;CORTE;2022-08-18;21;21;0;5;N
PITUBA;358;STC;CORTE;2022-08-23;19;19;0;3;N
SANTO ANTONIO DE JESUS;432;STC;CORTE;2022-08-08;13;13;0;2;N
REMANSO;391;EPS;BAIXA;2022-08-05;11;11;0;6;N
ITABERABA;217;EPS;RECORTE;2022-08-23;62;62;0;3;N
VITORIA DA CONQUISTA;503;STC;CORTE;2022-08-22;11;10;1;2;N
SENHOR DO BONFIM;454;EPS;CORTE;2022-08-09;12;12;0;3;N
SANTO AMARO;423;STC;CORTE;2022-08-22;21;19;2;2;N
ITABUNA;231;STC;RECORTE;2022-08-04;20;8;12;5;S
JEQUIE;269;STC;RECORTE;2022-08-04;20;16;4;5;S
RIBEIRA DO POMBAL;400;EPS;CORTE;2022-08-17;10;10;0;4;N
LAURO DE FREITAS;294;EPS;DISJUNTOR;2022-08-02;10;10;0;3;N
FEIRA DE SANTANA NORTE;108;EPS;CORTE;2022-08-12;20;20;0;6;N
ESPLANADA;78;EPS;CORTE;2022-08-04;17;17;0;5;N
ITABERABA;214;STC;CORTE;2022-08-23;21;21;0;3;N
GUANAMBI;142;STC;CORTE;2022-08-04;40;39;1;5;S
LUIS EDUARDO MAGALHAES;323;EPS;CORTE;2022-08-04;8;8;0;5;N
ITABERABA;215;STC;CORTE;2022-08-11;11;11;0;5;N
PITUBA;359;STC;CORTE;2022-08-11;19;18;1;5;N
AMARGOSA;6;EPS;RECORTE;2022-08-10;5;5;0;4;N
JUAZEIRO;284;STC;CORTE;2022-08-04;9;9;0;5;N
BARREIRAS;20;EPS;BAIXA;2022-08-17;4;4;0;4;N
GRACA;132;EPS;CORTE;2022-08-09;21;18;3;3;N
PAULO AFONSO;325;EPS;CORTE;2022-08-18;8;8;0;5;N
SANTO ANTONIO DE JESUS;430;EPS;CORTE;2022-08-18;4;4;0;5;N
ITABUNA;227;STC;CORTE;2022-08-04;16;16;0;5;N
SANTA MARIA DA VITORIA;418;EPS;BAIXA;2022-08-25;6;5;1;5;S
IBOTIRAMA;158;EPS;CORTE;2022-08-12;6;6;0;6;N
VITORIA DA CONQUISTA;517;EPS;CORTE;2022-08-12;15;15;0;6;N
IBOTIRAMA;160;STC;CORTE;2022-08-02;5;5;0;3;N
IBOTIRAMA;157;EPS;CORTE;2022-08-24;6;5;1;4;N
JACOBINA;260;EPS;CORTE;2022-08-23;6;6;0;3;N
ESPLANADA;80;EPS;BAIXA;2022-08-04;6;6;0;5;N
ITABERABA;214;EPS;CORTE;2022-08-09;5;5;0;3;N
LIVRAMENTO DE NOSSA SENHORA;305;STC;RECORTE;2022-08-24;5;5;0;4;N
ITAPOAN;253;EPS;BAIXA;2022-08-25;1;0;1;5;S
ESPLANADA;77;EPS;RECORTE;2022-08-17;10;9;1;4;N
SEABRA;440;STC;CORTE;2022-08-09;11;11;0;3;N
ITABUNA;226;STC;RECORTE;2022-08-17;16;5;11;4;N
SENHOR DO BONFIM;454;EPS;RECORTE;2022-08-10;6;6;0;4;N
SANTA MARIA DA VITORIA;414;EPS;CORTE;2022-08-02;10;10;0;3;N
LIVRAMENTO DE NOSSA SENHORA;310;EPS;CORTE;2022-08-23;10;10;0;3;N
GRACA;136;EPS;BAIXA;2022-08-11;17;15;2;5;N
IRECE;199;EPS;RECORTE;2022-08-03;6;6;0;4;N
FEIRA DE SANTANA SUL;123;EPS;CORTE;2022-08-19;54;50;4;6;N
EUNAPOLIS;88;EPS;CORTE;2022-08-11;2;1;1;5;N
JACOBINA;257;EPS;CORTE;2022-08-10;9;9;0;4;N
PORTO SEGURO;375;EPS;CORTE;2022-08-12;9;9;0;6;N
REMANSO;393;STC;CORTE;2022-08-17;20;20;0;4;S
SENHOR DO BONFIM;450;EPS;CORTE;2022-08-08;16;16;0;2;N
JUAZEIRO;292;EPS;CORTE;2022-08-17;15;15;0;4;N
BOM JESUS DA LAPA;34;EPS;CORTE;2022-08-11;5;5;0;5;N
LIVRAMENTO DE NOSSA SENHORA;311;EPS;CORTE;2022-08-11;5;4;1;5;N
SEABRA;438;EPS;CORTE;2022-08-19;11;10;1;6;N
ITAPOAN;250;STC;CORTE;2022-08-02;15;15;0;3;S
AMARGOSA;11;EPS;CORTE;2022-08-23;15;15;0;3;N
PAULO AFONSO;402;EPS;CORTE;2022-08-02;10;10;0;3;N
VALENCA;486;EPS;CORTE;2022-08-12;6;6;0;6;N
PORTO SEGURO;361;EPS;CORTE;2022-08-08;11;10;1;2;N
IRECE;193;EPS;CORTE;2022-08-23;15;14;1;3;S
ITABUNA;230;EPS;BAIXA;2022-08-04;5;4;1;5;N
FEIRA DE SANTANA NORTE;107;EPS;RECORTE;2022-08-25;36;36;0;5;N
GUANAMBI;142;STC;RECORTE;2022-08-05;15;15;0;6;S
ITAPOAN;254;STC;RECORTE;2022-08-04;4;3;1;5;S
FEIRA DE SANTANA SUL;125;STC;CORTE;2022-08-09;1;1;0;3;N
SERRINHA;463;STC;CORTE;2022-08-25;9;9;0;5;N
POSTO DA MATA;388;EPS;CORTE;2022-08-23;11;11;0;3;N
BOM JESUS DA LAPA;33;EPS;CORTE;2022-08-23;4;4;0;3;N
JACOBINA;256;EPS;CORTE;2022-08-22;5;5;0;2;N
JUAZEIRO;284;STC;RECORTE;2022-08-03;4;4;0;4;S
LUIS EDUARDO MAGALHAES;320;STC;CORTE;2022-08-05;11;0;11;6;N
GUANAMBI;138;STC;CORTE;2022-08-05;11;0;11;6;N
REMANSO;393;EPS;CORTE;2022-08-05;18;0;18;6;N
FEIRA DE SANTANA NORTE;110;STC;RECORTE;2022-08-03;1;1;0;4;N
PIRAJA;353;EPS;CORTE;2022-08-25;36;0;36;5;N
IRECE;193;EPS;CORTE;2022-08-25;27;0;27;5;N
PAULO AFONSO;332;EPS;CORTE;2022-08-08;9;8;1;2;N
PIRAJA;353;EPS;DISJUNTOR;2022-08-08;15;15;0;2;N
LAURO DE FREITAS;297;STC;CORTE;2022-08-22;16;16;0;2;N
ESPLANADA;83;EPS;CORTE;2022-08-18;13;13;0;5;N
LIVRAMENTO DE NOSSA SENHORA;308;STC;CORTE;2022-08-12;9;8;1;6;N
SERRINHA;458;EPS;CORTE;2022-08-22;14;14;0;2;N
BRUMADO;35;EPS;CORTE;2022-08-23;5;5;0;3;N
PIRAJA;350;EPS;CORTE;2022-08-12;16;16;0;6;N
IRECE;205;STC;CORTE;2022-08-18;21;20;1;5;N
JUAZEIRO;292;EPS;RECORTE;2022-08-18;8;5;3;5;N
IRECE;204;EPS;CORTE;2022-08-16;10;10;0;3;N
GRACA;137;EPS;CORTE;2022-08-23;22;19;3;3;N
IBOTIRAMA;165;STC;CORTE;2022-08-16;9;9;0;3;N
PITUBA;356;STC;CORTE;2022-08-22;6;4;2;2;S
SENHOR DO BONFIM;450;STC;RECORTE;2022-08-23;11;11;0;3;N
IRECE;205;EPS;CORTE;2022-08-04;13;12;1;5;N
SANTO AMARO;422;STC;CORTE;2022-08-11;9;9;0;5;N
ALAGOINHAS;3;EPS;CORTE;2022-08-09;9;9;0;3;N
AMARGOSA;11;EPS;RECORTE;2022-08-24;40;38;2;4;N
EUNAPOLIS;87;EPS;RECORTE;2022-08-24;3;3;0;4;N
POSTO DA MATA;388;EPS;RECORTE;2022-08-24;5;4;1;4;N
ITABERABA;219;EPS;CORTE;2022-08-23;4;4;0;3;N
SERRINHA;459;EPS;CORTE;2022-08-10;10;10;0;4;N
SENHOR DO BONFIM;447;STC;CORTE;2022-08-09;13;12;1;3;N
SANTA MARIA DA VITORIA;414;EPS;RECORTE;2022-08-03;5;5;0;4;N
SENHOR DO BONFIM;445;EPS;CORTE;2022-08-19;9;9;0;6;N
GUANAMBI;146;EPS;CORTE;2022-08-18;6;5;1;5;N
CONCEICAO DO COITE;76;EPS;CORTE;2022-08-15;7;7;0;2;N
ITABERABA;220;STC;CORTE;2022-08-25;21;20;1;5;N
CONCEICAO DO COITE;62;STC;CORTE;2022-08-25;11;11;0;5;N
JUAZEIRO;289;STC;CORTE;2022-08-18;2;2;0;5;N
IBOTIRAMA;166;STC;CORTE;2022-08-04;6;6;0;5;N
CANDEIAS;58;EPS;DISJUNTOR;2022-08-24;26;23;3;4;N
JUAZEIRO;288;EPS;CORTE;2022-08-16;10;9;1;3;N
ITAPOAN;250;STC;RECORTE;2022-08-05;19;0;19;6;N
GRACA;131;EPS;BAIXA;2022-08-22;10;0;10;2;N
JUAZEIRO;284;EPS;CORTE;2022-08-15;15;15;0;2;N
ESPLANADA;80;STC;CORTE;2022-08-19;11;11;0;6;N
BRUMADO;38;STC;RECORTE;2022-08-02;11;10;1;3;N
TEIXEIRA DE FREITAS;479;EPS;RECORTE;2022-08-11;16;16;0;5;N
ILHEUS;183;EPS;CORTE;2022-08-15;23;22;1;2;N
FEIRA DE SANTANA NORTE;115;STC;RECORTE;2022-08-17;13;12;1;4;N
ITAPOAN;254;EPS;CORTE;2022-08-16;19;19;0;3;N
VALENCA;494;STC;CORTE;2022-08-04;11;11;0;5;N
SANTO ANTONIO DE JESUS;426;STC;CORTE;2022-08-08;13;13;0;2;N
LAURO DE FREITAS;297;STC;RECORTE;2022-08-23;16;16;0;3;N
ALAGOINHAS;3;EPS;RECORTE;2022-08-10;48;43;5;4;N
RIBEIRA DO POMBAL;409;EPS;CORTE;2022-08-09;11;11;0;3;N
LUIS EDUARDO MAGALHAES;317;EPS;CORTE;2022-08-04;8;8;0;5;N
IPIAU;527;EPS;CORTE;2022-08-19;8;8;0;6;N
SANTO AMARO;421;EPS;RECORTE;2022-08-10;14;12;2;4;N
JACOBINA;262;EPS;CORTE;2022-08-24;8;8;0;4;N
ITABUNA;184;EPS;BAIXA;2022-08-17;8;8;0;4;N
EUNAPOLIS;87;EPS;BAIXA;2022-08-24;4;3;1;4;N
BOM JESUS DA LAPA;33;EPS;BAIXA;2022-08-24;2;2;0;4;N
REMANSO;392;EPS;BAIXA;2022-08-18;25;20;5;5;N
BRUMADO;47;EPS;CORTE;2022-08-02;6;5;1;3;N
BARREIRAS;20;EPS;CORTE;2022-08-18;7;6;1;5;N
PIRAJA;351;STC;RECORTE;2022-08-15;17;14;3;2;N
VALENCA;493;EPS;CORTE;2022-08-02;10;10;0;3;N
SEABRA;212;STC;CORTE;2022-08-23;9;9;0;3;N
BOM JESUS DA LAPA;32;EPS;CORTE;2022-08-12;4;4;0;6;N
JUAZEIRO;290;STC;RECORTE;2022-08-05;5;3;2;6;S
IRECE;202;STC;CORTE;2022-08-05;11;0;11;6;N
JUAZEIRO;286;STC;CORTE;2022-08-05;9;0;9;6;N
RIBEIRA DO POMBAL;410;EPS;BAIXA;2022-08-19;18;0;18;6;S
ITAPOAN;250;EPS;CORTE;2022-08-15;57;56;1;2;N
RIBEIRA DO POMBAL;405;EPS;CORTE;2022-08-08;12;12;0;2;N
SEABRA;441;STC;CORTE;2022-08-22;21;20;1;2;N
GRACA;136;EPS;CORTE;2022-08-12;21;20;1;6;N
BRUMADO;47;EPS;RECORTE;2022-08-03;4;4;0;4;N
SENHOR DO BONFIM;452;STC;CORTE;2022-08-23;8;7;1;3;N
LIVRAMENTO DE NOSSA SENHORA;305;EPS;CORTE;2022-08-11;5;5;0;5;N
ILHEUS;183;STC;DISJUNTOR;2022-08-10;18;17;1;4;S
GUANAMBI;142;EPS;RECORTE;2022-08-18;13;12;1;5;N
TEIXEIRA DE FREITAS;485;EPS;CORTE;2022-08-12;10;10;0;6;N
ITAPOAN;254;EPS;RECORTE;2022-08-17;38;36;2;4;N
ILHEUS;180;STC;CORTE;2022-08-16;21;19;2;3;N
BOM JESUS DA LAPA;28;EPS;CORTE;2022-08-11;5;4;1;5;N
ITABUNA;230;STC;CORTE;2022-08-19;21;21;0;6;N
IBOTIRAMA;163;EPS;CORTE;2022-08-03;7;7;0;4;N
SANTO ANTONIO DE JESUS;426;STC;RECORTE;2022-08-09;16;12;4;3;N
IRECE;210;EPS;CORTE;2022-08-18;15;14;1;5;N
PAULO AFONSO;341;EPS;RECORTE;2022-08-24;4;4;0;4;N
EUNAPOLIS;97;EPS;BAIXA;2022-08-25;16;16;0;5;S
LUIS EDUARDO MAGALHAES;317;EPS;RECORTE;2022-08-05;1;1;0;6;N
VITORIA DA CONQUISTA;506;EPS;CORTE;2022-08-23;14;12;2;3;N
ALAGOINHAS;3;EPS;BAIXA;2022-08-10;4;3;1;4;N
BOM JESUS DA LAPA;28;STC;CORTE;2022-08-25;13;13;0;5;N
TEIXEIRA DE FREITAS;484;EPS;CORTE;2022-08-24;9;9;0;4;N
SANTA MARIA DA VITORIA;415;EPS;CORTE;2022-08-15;6;6;0;2;N
SANTA MARIA DA VITORIA;417;STC;CORTE;2022-08-05;11;0;11;6;N
ITAPOAN;252;STC;CORTE;2022-08-05;19;0;19;6;N
POSTO DA MATA;385;EPS;BAIXA;2022-08-11;1;0;1;5;N
LAURO DE FREITAS;296;EPS;BAIXA;2022-08-19;17;0;17;6;S
PORTO SEGURO;376;EPS;CORTE;2022-08-25;16;0;16;5;N
VALENCA;487;EPS;CORTE;2022-08-25;11;0;11;5;N
ITAPETINGA;241;EPS;CORTE;2022-08-08;15;12;3;2;N
ITABUNA;225;EPS;CORTE;2022-08-16;12;11;1;3;N
GRACA;132;EPS;CORTE;2022-08-11;42;40;2;5;N
GRACA;131;EPS;CORTE;2022-08-23;22;21;1;3;N
BOM JESUS DA LAPA;23;EPS;CORTE;2022-08-22;10;10;0;2;N
SANTO AMARO;422;EPS;CORTE;2022-08-22;16;16;0;2;N
ITABUNA;229;STC;DISJUNTOR;2022-08-12;18;18;0;6;S
PITUBA;357;EPS;CORTE;2022-08-23;17;17;0;3;N
IBOTIRAMA;163;EPS;RECORTE;2022-08-04;7;7;0;5;N
ITABERABA;213;EPS;CORTE;2022-08-23;4;4;0;3;N
FEIRA DE SANTANA NORTE;109;EPS;CORTE;2022-08-02;24;22;2;3;N
SANTA MARIA DA VITORIA;412;STC;CORTE;2022-08-16;11;9;2;3;N
IRECE;207;STC;CORTE;2022-08-19;21;18;3;6;N
SANTO ANTONIO DE JESUS;431;EPS;CORTE;2022-08-08;6;4;2;2;N
SANTO AMARO;424;STC;CORTE;2022-08-12;9;9;0;6;N
ITAPETINGA;241;STC;CORTE;2022-08-22;9;7;2;2;N
IRECE;199;EPS;CORTE;2022-08-04;8;6;2;5;N
ITABUNA;226;STC;CORTE;2022-08-18;16;16;0;5;N
SANTO ANTONIO DE JESUS;435;EPS;RECORTE;2022-08-10;6;6;0;4;N
ALAGOINHAS;4;EPS;CORTE;2022-08-22;18;18;0;2;N
VITORIA DA CONQUISTA;503;EPS;CORTE;2022-08-10;15;15;0;4;N
SERRINHA;468;EPS;CORTE;2022-08-02;5;5;0;3;N
ITAPOAN;254;EPS;BAIXA;2022-08-17;19;17;2;4;N
JUAZEIRO;284;EPS;BAIXA;2022-08-16;13;13;0;3;N
LUIS EDUARDO MAGALHAES;322;EPS;CORTE;2022-08-18;7;7;0;5;N
VITORIA DA CONQUISTA;518;STC;CORTE;2022-08-16;11;10;1;3;N
ITABUNA;230;STC;RECORTE;2022-08-18;16;7;9;5;S
GRACA;137;STC;RECORTE;2022-08-15;17;17;0;2;N
ITABERABA;214;STC;CORTE;2022-08-25;21;18;3;5;N
GRACA;132;STC;CORTE;2022-08-25;8;8;0;5;N
RIBEIRA DO POMBAL;400;EPS;CORTE;2022-08-19;10;10;0;6;N
BOM JESUS DA LAPA;27;EPS;RECORTE;2022-08-24;2;2;0;4;N
CONCEICAO DO COITE;72;STC;CORTE;2022-08-05;10;0;10;6;N
ITAPETINGA;245;STC;RECORTE;2022-08-24;13;13;0;4;N
JACOBINA;257;EPS;CORTE;2022-08-12;9;9;0;6;N
FEIRA DE SANTANA NORTE;109;EPS;RECORTE;2022-08-03;36;36;0;4;N
IRECE;194;EPS;CORTE;2022-08-15;13;13;0;2;N
JEQUIE;275;STC;CORTE;2022-08-09;11;10;1;3;N
SANTO ANTONIO DE JESUS;428;STC;CORTE;2022-08-09;19;19;0;3;N
LUIS EDUARDO MAGALHAES;319;STC;CORTE;2022-08-19;13;13;0;6;N
CONCEICAO DO COITE;68;STC;CORTE;2022-08-04;11;11;0;5;N
PORTO SEGURO;376;EPS;CORTE;2022-08-02;16;15;1;3;N
PIRAJA;354;EPS;CORTE;2022-08-15;32;29;3;2;N
REMANSO;394;STC;CORTE;2022-08-09;9;9;0;3;N
CAMACARI;50;STC;CORTE;2022-08-09;16;16;0;3;N
REMANSO;393;STC;CORTE;2022-08-19;10;10;0;6;S
SANTO ANTONIO DE JESUS;8;STC;RECORTE;2022-08-23;16;15;1;3;N
VITORIA DA CONQUISTA;499;STC;CORTE;2022-08-23;11;11;0;3;N
IBOTIRAMA;155;STC;CORTE;2022-08-15;9;9;0;2;N
VITORIA DA CONQUISTA;500;STC;CORTE;2022-08-11;11;11;0;5;N
ITABUNA;225;EPS;RECORTE;2022-08-17;8;8;0;4;N
PITUBA;357;EPS;RECORTE;2022-08-24;26;23;3;4;N
IRECE;198;EPS;RECORTE;2022-08-17;5;4;1;4;N
ITAPOAN;251;EPS;BAIXA;2022-08-04;13;13;0;5;N
FEIRA DE SANTANA NORTE;113;EPS;BAIXA;2022-08-04;8;8;0;5;N
BOM JESUS DA LAPA;27;EPS;BAIXA;2022-08-24;1;1;0;4;N
JACOBINA;259;STC;CORTE;2022-08-02;9;9;0;3;N
ITAPETINGA;242;STC;RECORTE;2022-08-11;13;13;0;5;N
ALAGOINHAS;1;STC;CORTE;2022-08-23;1;1;0;3;N
PERIPERI;349;EPS;CORTE;2022-08-23;11;9;2;3;N
JACOBINA;256;EPS;CORTE;2022-08-24;8;8;0;4;N
FEIRA DE SANTANA SUL;124;EPS;CORTE;2022-08-09;19;17;2;3;N
BOM JESUS DA LAPA;33;EPS;CORTE;2022-08-25;4;0;4;5;N
LAURO DE FREITAS;296;EPS;CORTE;2022-08-22;15;15;0;2;N
JACOBINA;256;EPS;RECORTE;2022-08-25;8;7;1;5;N
POSTO DA MATA;385;EPS;CORTE;2022-08-12;14;14;0;6;N
PIRAJA;351;EPS;CORTE;2022-08-02;23;22;1;3;N
PITUBA;356;EPS;CORTE;2022-08-12;38;34;4;6;N
AMARGOSA;10;STC;CORTE;2022-08-02;20;20;0;3;N
SENHOR DO BONFIM;446;EPS;CORTE;2022-08-09;12;12;0;3;N
EUNAPOLIS;86;STC;CORTE;2022-08-02;21;21;0;3;N
SERRINHA;459;EPS;CORTE;2022-08-12;9;8;1;6;N
ITAPETINGA;248;STC;CORTE;2022-08-12;9;9;0;6;N
ILHEUS;187;EPS;CORTE;2022-08-18;19;17;2;5;N
PERIPERI;347;STC;CORTE;2022-08-12;16;14;2;6;N
PIRAJA;352;STC;CORTE;2022-08-04;17;15;2;5;N
LAURO DE FREITAS;298;STC;CORTE;2022-08-12;16;15;1;6;N
ESPLANADA;84;EPS;CORTE;2022-08-08;15;15;0;2;N
ITABERABA;221;STC;CORTE;2022-08-15;11;11;0;2;N
SENHOR DO BONFIM;446;STC;CORTE;2022-08-23;11;11;0;3;N
REMANSO;390;STC;CORTE;2022-08-08;16;15;1;2;N
ITABUNA;233;STC;CORTE;2022-08-08;16;16;0;2;N
SERRINHA;459;STC;CORTE;2022-08-24;15;15;0;4;S
LIVRAMENTO DE NOSSA SENHORA;308;STC;CORTE;2022-08-12;13;13;0;6;S
SENHOR DO BONFIM;447;STC;CORTE;2022-08-11;13;13;0;5;N
PORTO SEGURO;376;EPS;RECORTE;2022-08-03;36;35;1;4;N
LUIS EDUARDO MAGALHAES;315;STC;CORTE;2022-08-18;21;21;0;5;N
ILHEUS;174;EPS;CORTE;2022-08-02;15;15;0;3;N
FEIRA DE SANTANA NORTE;115;STC;CORTE;2022-08-18;22;21;1;5;N
SANTA MARIA DA VITORIA;535;STC;CORTE;2022-08-12;11;11;0;6;N
JUAZEIRO;290;STC;CORTE;2022-08-08;1;1;0;2;N
LIVRAMENTO DE NOSSA SENHORA;301;EPS;BAIXA;2022-08-11;10;10;0;5;N
SANTO AMARO;421;EPS;CORTE;2022-08-11;11;11;0;5;N
SANTO AMARO;425;EPS;RECORTE;2022-08-11;42;9;33;5;S
ITABUNA;225;EPS;BAIXA;2022-08-17;8;8;0;4;N
CANDEIAS;533;EPS;DISJUNTOR;2022-08-15;8;7;1;2;N
VALENCA;487;EPS;RECORTE;2022-08-03;13;13;0;4;N
RIBEIRA DO POMBAL;408;STC;CORTE;2022-08-11;11;11;0;5;N
ILHEUS;178;STC;RECORTE;2022-08-16;10;4;6;3;S
SERRINHA;458;EPS;CORTE;2022-08-24;12;12;0;4;N
CONCEICAO DO COITE;68;STC;RECORTE;2022-08-05;11;0;11;6;N
PAULO AFONSO;325;EPS;BAIXA;2022-08-19;13;0;13;6;S
GRACA;137;EPS;CORTE;2022-08-25;63;0;63;5;N
ITABERABA;219;EPS;CORTE;2022-08-25;3;0;3;5;N
JACOBINA;264;STC;CORTE;2022-08-16;13;11;2;3;N
JUAZEIRO;284;EPS;CORTE;2022-08-17;15;13;2;4;N
PORTO SEGURO;369;STC;CORTE;2022-08-02;11;10;1;3;N
SENHOR DO BONFIM;446;EPS;RECORTE;2022-08-10;6;6;0;4;N
CONCEICAO DO COITE;76;EPS;RECORTE;2022-08-18;6;4;2;5;N
VALENCA;492;EPS;CORTE;2022-08-16;14;14;0;3;N
SANTO AMARO;420;EPS;RECORTE;2022-08-24;21;20;1;4;N
CAMACARI;55;STC;CORTE;2022-08-23;16;16;0;3;N
VALENCA;493;STC;CORTE;2022-08-18;17;17;0;5;N
IBOTIRAMA;160;EPS;CORTE;2022-08-15;7;7;0;2;N
BOM JESUS DA LAPA;33;EPS;CORTE;2022-08-02;7;7;0;3;N
VALENCA;493;EPS;CORTE;2022-08-04;8;8;0;5;N
GUANAMBI;142;EPS;CORTE;2022-08-19;6;6;0;6;N
POSTO DA MATA;381;EPS;CORTE;2022-08-11;7;7;0;5;N
SANTO ANTONIO DE JESUS;429;EPS;RECORTE;2022-08-10;6;5;1;4;N
JUAZEIRO;290;STC;RECORTE;2022-08-09;16;8;8;3;N
PIRAJA;355;EPS;BAIXA;2022-08-04;20;16;4;5;N
JEQUIE;266;STC;CORTE;2022-08-19;7;7;0;6;N
ILHEUS;178;EPS;BAIXA;2022-08-04;10;9;1;5;N
ALAGOINHAS;4;STC;RECORTE;2022-08-12;15;12;3;6;S
SEABRA;444;EPS;CORTE;2022-08-23;10;9;1;3;N
PAULO AFONSO;328;EPS;CORTE;2022-08-09;8;7;1;3;N
SERRINHA;458;EPS;RECORTE;2022-08-25;6;4;2;5;N
SERRINHA;455;STC;CORTE;2022-08-25;11;11;0;5;N
LAURO DE FREITAS;293;EPS;CORTE;2022-08-09;18;17;1;3;N
IBOTIRAMA;162;STC;CORTE;2022-08-05;9;0;9;6;N
LAURO DE FREITAS;296;EPS;DISJUNTOR;2022-08-05;13;0;13;6;N
JUAZEIRO;285;EPS;CORTE;2022-08-05;18;0;18;6;N
ITABERABA;219;EPS;CORTE;2022-08-02;5;5;0;3;N
TEIXEIRA DE FREITAS;472;STC;CORTE;2022-08-12;15;15;0;6;N
IRECE;211;EPS;CORTE;2022-08-08;14;13;1;2;N
VALENCA;490;EPS;DISJUNTOR;2022-08-23;36;36;0;3;N
GUANAMBI;142;EPS;DISJUNTOR;2022-08-02;12;12;0;3;N
FEIRA DE SANTANA SUL;125;EPS;CORTE;2022-08-22;18;18;0;2;N
BOM JESUS DA LAPA;33;EPS;RECORTE;2022-08-03;8;8;0;4;N
ILHEUS;183;EPS;RECORTE;2022-08-18;15;14;1;5;N
JUAZEIRO;284;EPS;RECORTE;2022-08-18;8;7;1;5;N
CONCEICAO DO COITE;62;STC;CORTE;2022-08-04;11;11;0;5;N
ILHEUS;179;EPS;CORTE;2022-08-16;46;42;4;3;N
RIBEIRA DO POMBAL;405;EPS;CORTE;2022-08-10;10;10;0;4;N
IRECE;196;EPS;CORTE;2022-08-16;10;10;0;3;N
ESPLANADA;77;STC;CORTE;2022-08-08;22;22;0;2;N
ITABUNA;231;STC;CORTE;2022-08-09;16;16;0;3;N
GRACA;137;EPS;CORTE;2022-08-02;71;60;11;3;N
SANTO ANTONIO DE JESUS;435;EPS;CORTE;2022-08-11;5;5;0;5;N
SENHOR DO BONFIM;452;EPS;CORTE;2022-08-11;12;12;0;5;N
BRUMADO;42;EPS;CORTE;2022-08-15;8;7;1;2;N
BRUMADO;44;EPS;DISJUNTOR;2022-08-23;8;8;0;3;N
VALENCA;491;EPS;DISJUNTOR;2022-08-11;32;31;1;5;N
IRECE;211;STC;CORTE;2022-08-22;21;21;0;2;N
IPIAU;190;STC;CORTE;2022-08-08;13;13;0;2;N
BRUMADO;46;EPS;RECORTE;2022-08-17;4;4;0;4;N
LUIS EDUARDO MAGALHAES;318;STC;RECORTE;2022-08-09;13;13;0;3;N
VITORIA DA CONQUISTA;513;STC;RECORTE;2022-08-03;4;1;3;4;S
ITABUNA;229;EPS;CORTE;2022-08-19;7;7;0;6;N
IRECE;201;STC;RECORTE;2022-08-18;12;10;2;5;S
GUANAMBI;138;EPS;CORTE;2022-08-18;6;6;0;5;N
SENHOR DO BONFIM;452;STC;CORTE;2022-08-25;11;10;1;5;N
PORTO SEGURO;377;EPS;CORTE;2022-08-15;9;9;0;2;N
SEABRA;444;EPS;RECORTE;2022-08-24;6;5;1;4;N
VALENCA;490;STC;CORTE;2022-08-05;17;0;17;6;N
ITAPOAN;251;EPS;CORTE;2022-08-05;46;0;46;6;N
LUIS EDUARDO MAGALHAES;313;EPS;CORTE;2022-08-05;8;0;8;6;N
JACOBINA;264;STC;RECORTE;2022-08-17;1;1;0;4;N
BOM JESUS DA LAPA;27;EPS;CORTE;2022-08-25;3;0;3;5;N
VITORIA DA CONQUISTA;502;EPS;CORTE;2022-08-24;28;26;2;4;N
PITUBA;359;STC;CORTE;2022-08-15;19;19;0;2;N
ITABUNA;225;EPS;CORTE;2022-08-18;11;9;2;5;N
ITAPETINGA;241;EPS;CORTE;2022-08-10;14;13;1;4;N
GRACA;137;EPS;RECORTE;2022-08-03;19;18;1;4;N
CAMACARI;52;EPS;CORTE;2022-08-22;18;17;1;2;N
ILHEUS;178;STC;DISJUNTOR;2022-08-23;10;10;0;3;S
AMARGOSA;11;STC;CORTE;2022-08-15;18;14;4;2;N
BRUMADO;40;EPS;DISJUNTOR;2022-08-22;7;7;0;2;N
CAMACARI;53;EPS;CORTE;2022-08-10;20;20;0;4;N
BRUMADO;40;STC;CORTE;2022-08-04;11;11;0;5;N
RIBEIRA DO POMBAL;405;EPS;RECORTE;2022-08-11;9;9;0;5;N
SERRINHA;459;STC;RECORTE;2022-08-02;5;2;3;3;S
FEIRA DE SANTANA SUL;123;STC;CORTE;2022-08-11;2;1;1;5;N
FEIRA DE SANTANA NORTE;109;EPS;CORTE;2022-08-04;54;52;2;5;N
ITAPETINGA;241;STC;CORTE;2022-08-22;16;14;2;2;S
SENHOR DO BONFIM;451;EPS;RECORTE;2022-08-24;11;11;0;4;N
FEIRA DE SANTANA NORTE;108;EPS;CORTE;2022-08-16;30;28;2;3;N
SANTO ANTONIO DE JESUS;9;STC;CORTE;2022-08-12;13;13;0;6;N
SANTA MARIA DA VITORIA;412;STC;CORTE;2022-08-18;14;14;0;5;N
LUIS EDUARDO MAGALHAES;323;EPS;CORTE;2022-08-08;10;10;0;2;N
ESPLANADA;77;STC;RECORTE;2022-08-09;16;11;5;3;N
ITAPETINGA;242;STC;CORTE;2022-08-12;9;9;0;6;N
PIRAJA;354;EPS;DISJUNTOR;2022-08-23;44;40;4;3;N
JACOBINA;262;EPS;BAIXA;2022-08-25;19;19;0;5;S
PAULO AFONSO;340;STC;RECORTE;2022-08-03;1;1;0;4;N
BOM JESUS DA LAPA;29;STC;RECORTE;2022-08-16;11;11;0;3;N
ILHEUS;180;STC;RECORTE;2022-08-19;21;13;8;6;N
JACOBINA;262;EPS;CORTE;2022-08-03;7;7;0;4;N
LIVRAMENTO DE NOSSA SENHORA;301;EPS;CORTE;2022-08-12;6;6;0;6;N
FEIRA DE SANTANA SUL;122;STC;CORTE;2022-08-23;2;2;0;3;N
PITUBA;357;EPS;CORTE;2022-08-25;14;0;14;5;N
GRACA;131;EPS;CORTE;2022-08-25;21;0;21;5;N
ITABERABA;213;EPS;CORTE;2022-08-25;3;0;3;5;N
FEIRA DE SANTANA NORTE;108;EPS;RECORTE;2022-08-17;6;6;0;4;N
SANTO ANTONIO DE JESUS;427;STC;CORTE;2022-08-23;16;15;1;3;N
ILHEUS;178;EPS;CORTE;2022-08-05;129;123;6;6;N
REMANSO;393;STC;CORTE;2022-08-23;15;15;0;3;N
SERRINHA;463;EPS;CORTE;2022-08-15;12;12;0;2;N
RIBEIRA DO POMBAL;397;STC;CORTE;2022-08-22;11;11;0;2;N
ITAPETINGA;237;STC;CORTE;2022-08-23;9;9;0;3;N
BRUMADO;49;STC;CORTE;2022-08-19;11;11;0;6;N
CONCEICAO DO COITE;66;EPS;CORTE;2022-08-16;6;6;0;3;N
REMANSO;393;EPS;CORTE;2022-08-09;48;46;2;3;N
VALENCA;495;STC;CORTE;2022-08-19;17;17;0;6;N
LUIS EDUARDO MAGALHAES;320;STC;CORTE;2022-08-09;11;11;0;3;N
LUIS EDUARDO MAGALHAES;323;STC;RECORTE;2022-08-23;21;19;2;3;N
SANTO AMARO;421;EPS;DISJUNTOR;2022-08-19;4;4;0;6;N
BARREIRAS;15;EPS;CORTE;2022-08-08;10;10;0;2;N
JACOBINA;258;EPS;CORTE;2022-08-02;9;9;0;3;N
LIVRAMENTO DE NOSSA SENHORA;311;EPS;CORTE;2022-08-15;6;6;0;2;N
ITABUNA;185;EPS;CORTE;2022-08-08;20;19;1;2;N
PITUBA;357;EPS;DISJUNTOR;2022-08-08;1;1;0;2;N
ILHEUS;179;EPS;BAIXA;2022-08-17;10;8;2;4;N
TEIXEIRA DE FREITAS;484;EPS;BAIXA;2022-08-25;32;23;9;5;S
IBOTIRAMA;155;EPS;CORTE;2022-08-03;8;8;0;4;N
JACOBINA;258;STC;CORTE;2022-08-16;2;2;0;3;N
SANTO AMARO;424;STC;RECORTE;2022-08-15;13;12;1;2;N
ITABUNA;227;STC;RECORTE;2022-08-09;16;6;10;3;N
VALENCA;487;EPS;CORTE;2022-08-04;8;7;1;5;N
VITORIA DA CONQUISTA;499;STC;CORTE;2022-08-25;11;9;2;5;N
ALAGOINHAS;1;STC;CORTE;2022-08-25;19;18;1;5;N
LUIS EDUARDO MAGALHAES;318;EPS;CORTE;2022-08-19;7;7;0;6;N
SANTO ANTONIO DE JESUS;427;EPS;CORTE;2022-08-09;5;4;1;3;N
VITORIA DA CONQUISTA;515;STC;CORTE;2022-08-05;11;0;11;6;N
SERRINHA;465;STC;CORTE;2022-08-05;11;0;11;6;N
FEIRA DE SANTANA NORTE;106;STC;CORTE;2022-08-05;5;0;5;6;N
PIRAJA;355;EPS;CORTE;2022-08-05;51;0;51;6;N
IRECE;195;EPS;CORTE;2022-08-05;8;0;8;6;N
PERIPERI;349;EPS;CORTE;2022-08-25;13;0;13;5;N
BOM JESUS DA LAPA;31;STC;CORTE;2022-08-16;11;10;1;3;N
PIRAJA;353;EPS;DISJUNTOR;2022-08-12;36;30;6;6;N
BOM JESUS DA LAPA;32;STC;CORTE;2022-08-04;9;9;0;5;N
IRECE;205;EPS;CORTE;2022-08-08;13;10;3;2;N
ILHEUS;173;EPS;CORTE;2022-08-16;23;22;1;3;N
SERRINHA;464;EPS;RECORTE;2022-08-04;14;14;0;5;N
PIRAJA;350;EPS;CORTE;2022-08-16;15;15;0;3;N
PAULO AFONSO;332;EPS;CORTE;2022-08-12;8;7;1;6;N
LAURO DE FREITAS;296;EPS;CORTE;2022-08-24;14;14;0;4;N
SENHOR DO BONFIM;446;EPS;CORTE;2022-08-11;12;12;0;5;N
REMANSO;393;EPS;RECORTE;2022-08-10;36;33;3;4;N
PITUBA;357;EPS;CORTE;2022-08-02;27;26;1;3;N
PERIPERI;348;STC;CORTE;2022-08-02;31;28;3;3;N
PAULO AFONSO;334;STC;CORTE;2022-08-02;11;11;0;3;N
SENHOR DO BONFIM;445;EPS;CORTE;2022-08-23;10;9;1;3;N
POSTO DA MATA;386;EPS;CORTE;2022-08-02;7;7;0;3;N
LIVRAMENTO DE NOSSA SENHORA;308;STC;CORTE;2022-08-16;13;12;1;3;N
PIRAJA;351;EPS;CORTE;2022-08-04;14;14;0;5;N
FEIRA DE SANTANA NORTE;116;STC;CORTE;2022-08-08;11;11;0;2;N
CAMACARI;50;STC;RECORTE;2022-08-12;16;10;6;6;N
RIBEIRA DO POMBAL;410;EPS;RECORTE;2022-08-25;9;7;2;5;N
LAURO DE FREITAS;298;STC;CORTE;2022-08-12;15;15;0;6;S
ITABERABA;222;STC;CORTE;2022-08-03;3;3;0;4;S
SANTO ANTONIO DE JESUS;431;EPS;BAIXA;2022-08-11;15;14;1;5;N
SANTA MARIA DA VITORIA;412;EPS;BAIXA;2022-08-05;3;3;0;6;N
FEIRA DE SANTANA NORTE;108;EPS;BAIXA;2022-08-17;7;6;1;4;N
REMANSO;389;EPS;CORTE;2022-08-08;12;11;1;2;N
JACOBINA;258;STC;RECORTE;2022-08-17;2;2;0;4;N
BARREIRAS;16;STC;RECORTE;2022-08-09;4;4;0;3;S
ITAPETINGA;247;STC;CORTE;2022-08-24;18;18;0;4;S
PORTO SEGURO;371;EPS;CORTE;2022-08-15;9;9;0;2;N
ILHEUS;178;STC;RECORTE;2022-08-18;6;2;4;5;S
ITABERABA;220;EPS;CORTE;2022-08-15;4;4;0;2;N
EUNAPOLIS;87;EPS;DISJUNTOR;2022-08-10;3;3;0;4;N
CONCEICAO DO COITE;64;STC;CORTE;2022-08-05;11;0;11;6;N
PORTO SEGURO;373;STC;CORTE;2022-08-05;12;0;12;6;N
ITABERABA;222;STC;CORTE;2022-08-05;6;0;6;6;N
FEIRA DE SANTANA SUL;121;STC;CORTE;2022-08-12;1;1;0;6;N
ITABUNA;236;STC;RECORTE;2022-08-24;16;16;0;4;N
JUAZEIRO;284;EPS;CORTE;2022-08-19;15;15;0;6;N
ITABERABA;218;STC;CORTE;2022-08-04;10;10;0;5;N
SENHOR DO BONFIM;445;EPS;RECORTE;2022-08-24;5;4;1;4;N
PITUBA;357;EPS;RECORTE;2022-08-03;28;27;1;4;N
BARREIRAS;20;EPS;CORTE;2022-08-22;7;6;1;2;N
PORTO SEGURO;369;STC;CORTE;2022-08-04;11;11;0;5;N
JACOBINA;263;EPS;CORTE;2022-08-16;8;8;0;3;N
SERRINHA;456;STC;CORTE;2022-08-15;11;11;0;2;N
BARREIRAS;22;STC;CORTE;2022-08-12;7;7;0;6;N
ILHEUS;173;EPS;RECORTE;2022-08-17;9;6;3;4;N
VITORIA DA CONQUISTA;519;EPS;CORTE;2022-08-17;30;28;2;4;N
ESPLANADA;81;STC;CORTE;2022-08-11;11;10;1;5;N
JUAZEIRO;290;STC;RECORTE;2022-08-11;16;16;0;5;N
ITABERABA;217;STC;CORTE;2022-08-16;22;22;0;3;N
POSTO DA MATA;386;EPS;RECORTE;2022-08-03;6;6;0;4;N
PORTO SEGURO;368;STC;CORTE;2022-08-16;11;10;1;3;N
VALENCA;492;EPS;CORTE;2022-08-18;14;12;2;5;N
ILHEUS;183;EPS;CORTE;2022-08-19;24;24;0;6;N
JACOBINA;256;EPS;BAIXA;2022-08-25;11;11;0;5;S
SANTO AMARO;419;STC;CORTE;2022-08-02;9;9;0;3;N
PAULO AFONSO;328;EPS;CORTE;2022-08-11;8;8;0;5;N
LAURO DE FREITAS;296;EPS;RECORTE;2022-08-25;7;7;0;5;N
FEIRA DE SANTANA NORTE;115;STC;RECORTE;2022-08-19;5;3;2;6;S
PERIPERI;348;STC;RECORTE;2022-08-03;19;19;0;4;N
JUAZEIRO;290;STC;RECORTE;2022-08-09;5;5;0;3;S
PERIPERI;347;STC;RECORTE;2022-08-15;19;15;4;2;N
EUNAPOLIS;85;EPS;RECORTE;2022-08-03;5;5;0;4;N
SANTO ANTONIO DE JESUS;433;STC;CORTE;2022-08-25;19;19;0;5;N
LAURO DE FREITAS;293;STC;CORTE;2022-08-25;16;16;0;5;N
CAMACARI;55;STC;CORTE;2022-08-25;16;16;0;5;N
SERRINHA;464;EPS;BAIXA;2022-08-04;2;2;0;5;N
VALENCA;487;EPS;BAIXA;2022-08-05;18;2;16;6;N
PIRAJA;352;STC;RECORTE;2022-08-05;15;1;14;6;S
IBOTIRAMA;161;EPS;CORTE;2022-08-05;6;0;6;6;N
SEABRA;441;EPS;CORTE;2022-08-12;14;13;1;6;N
JEQUIE;275;EPS;CORTE;2022-08-22;25;23;2;2;N
IPIAU;189;EPS;CORTE;2022-08-08;11;10;1;2;N
RIBEIRA DO POMBAL;405;EPS;CORTE;2022-08-12;10;10;0;6;N
ILHEUS;179;EPS;CORTE;2022-08-18;21;21;0;5;N
ITAPOAN;252;STC;CORTE;2022-08-09;19;18;1;3;N
ITABUNA;230;EPS;CORTE;2022-08-09;18;17;1;3;N
BARREIRAS;18;STC;CORTE;2022-08-11;15;14;1;5;N
SANTA MARIA DA VITORIA;417;STC;CORTE;2022-08-09;11;8;3;3;N
AMARGOSA;5;STC;RECORTE;2022-08-16;19;18;1;3;N
GUANAMBI;142;EPS;DISJUNTOR;2022-08-04;13;12;1;5;N
GUANAMBI;139;EPS;CORTE;2022-08-08;7;7;0;2;N
JEQUIE;266;STC;RECORTE;2022-08-22;11;5;6;2;N
ITABERABA;217;STC;RECORTE;2022-08-17;42;30;12;4;N
ALAGOINHAS;1;STC;RECORTE;2022-08-03;5;5;0;4;N
PIRAJA;351;EPS;BAIXA;2022-08-05;1;1;0;6;N
FEIRA DE SANTANA SUL;128;STC;CORTE;2022-08-02;2;2;0;3;N
ESPLANADA;80;EPS;RECORTE;2022-08-10;7;5;2;4;N
ILHEUS;173;EPS;BAIXA;2022-08-17;10;7;3;4;N
PORTO SEGURO;369;STC;RECORTE;2022-08-03;7;2;5;4;S
EUNAPOLIS;105;EPS;CORTE;2022-08-08;15;11;4;2;N
IBOTIRAMA;171;STC;CORTE;2022-08-22;11;9;2;2;N
FEIRA DE SANTANA SUL;125;EPS;CORTE;2022-08-24;18;18;0;4;N
TEIXEIRA DE FREITAS;470;EPS;CORTE;2022-08-24;8;8;0;4;N
IRECE;210;EPS;CORTE;2022-08-22;3;3;0;2;N
SANTA MARIA DA VITORIA;415;EPS;CORTE;2022-08-19;2;2;0;6;N
BOM JESUS DA LAPA;28;EPS;CORTE;2022-08-15;5;5;0;2;N
TEIXEIRA DE FREITAS;485;EPS;CORTE;2022-08-16;9;9;0;3;N
EUNAPOLIS;90;EPS;CORTE;2022-08-16;14;14;0;3;N
IBOTIRAMA;171;EPS;CORTE;2022-08-08;4;4;0;2;N
SENHOR DO BONFIM;451;EPS;CORTE;2022-08-25;10;0;10;5;N
PITUBA;358;EPS;CORTE;2022-08-15;20;19;1;2;N
ITAPETINGA;241;EPS;CORTE;2022-08-12;12;12;0;6;N
FEIRA DE SANTANA SUL;125;EPS;RECORTE;2022-08-25;30;17;13;5;N
ITAPOAN;250;EPS;RECORTE;2022-08-18;140;114;26;5;S
BRUMADO;39;STC;CORTE;2022-08-18;11;11;0;5;N
SANTO AMARO;424;EPS;CORTE;2022-08-02;28;26;2;3;N
SANTO AMARO;425;STC;CORTE;2022-08-04;9;9;0;5;N
VITORIA DA CONQUISTA;508;EPS;RECORTE;2022-08-04;16;15;1;5;N
RIBEIRA DO POMBAL;400;EPS;CORTE;2022-08-23;9;8;1;3;N
BOM JESUS DA LAPA;26;STC;CORTE;2022-08-04;9;9;0;5;N
IRECE;193;STC;CORTE;2022-08-19;42;39;3;6;N
VITORIA DA CONQUISTA;505;STC;CORTE;2022-08-04;11;11;0;5;N
IRECE;207;STC;CORTE;2022-08-23;21;20;1;3;N
SANTO AMARO;424;STC;CORTE;2022-08-16;9;9;0;3;N
FEIRA DE SANTANA SUL;121;EPS;CORTE;2022-08-23;18;15;3;3;N
SEABRA;437;STC;CORTE;2022-08-23;4;4;0;3;S
SENHOR DO BONFIM;453;STC;RECORTE;2022-08-16;11;10;1;3;N
SANTO ANTONIO DE JESUS;433;STC;CORTE;2022-08-02;19;17;2;3;N
GRACA;132;EPS;CORTE;2022-08-15;40;39;1;2;N
AMARGOSA;10;EPS;CORTE;2022-08-15;5;5;0;2;N
JUAZEIRO;292;STC;CORTE;2022-08-11;9;8;1;5;N
ITABUNA;226;EPS;CORTE;2022-08-08;18;17;1;2;N
SANTO ANTONIO DE JESUS;8;EPS;CORTE;2022-08-12;5;5;0;6;N
ITABUNA;226;STC;CORTE;2022-08-22;16;16;0;2;N
SANTA MARIA DA VITORIA;413;STC;CORTE;2022-08-08;6;6;0;2;N
RIBEIRA DO POMBAL;404;EPS;RECORTE;2022-08-25;7;5;2;5;N
SANTO ANTONIO DE JESUS;434;EPS;RECORTE;2022-08-24;15;7;8;4;S
SERRINHA;458;EPS;RECORTE;2022-08-04;7;6;1;5;N
EUNAPOLIS;88;EPS;DISJUNTOR;2022-08-23;9;8;1;3;N
BOM JESUS DA LAPA;25;STC;CORTE;2022-08-16;11;11;0;3;N
ESPLANADA;80;EPS;BAIXA;2022-08-10;2;2;0;4;N
FEIRA DE SANTANA NORTE;108;EPS;CORTE;2022-08-18;12;9;3;5;N
BRUMADO;44;STC;RECORTE;2022-08-08;11;7;4;2;N
GUANAMBI;148;EPS;CORTE;2022-08-23;5;5;0;3;N
ITAPETINGA;241;STC;CORTE;2022-08-24;17;17;0;4;S
ILHEUS;180;STC;RECORTE;2022-08-19;12;11;1;6;S
FEIRA DE SANTANA SUL;128;STC;RECORTE;2022-08-03;2;2;0;4;N
ILHEUS;181;STC;RECORTE;2022-08-09;14;5;9;3;N
TEIXEIRA DE FREITAS;472;STC;RECORTE;2022-08-15;17;16;1;2;N
FEIRA DE SANTANA SUL;122;STC;CORTE;2022-08-25;22;21;1;5;N
SEABRA;437;STC;CORTE;2022-08-25;9;7;2;5;N
GUANAMBI;149;EPS;CORTE;2022-08-11;7;7;0;5;N
ITABUNA;230;EPS;RECORTE;2022-08-10;7;5;2;4;N
SANTO ANTONIO DE JESUS;431;EPS;CORTE;2022-08-12;5;5;0;6;N
IRECE;207;EPS;CORTE;2022-08-09;14;14;0;3;N
PAULO AFONSO;340;STC;RECORTE;2022-08-05;11;0;11;6;N
AMARGOSA;12;STC;CORTE;2022-08-05;16;0;16;6;N
GRACA;134;STC;CORTE;2022-08-05;6;0;6;6;N
PIRAJA;354;EPS;DISJUNTOR;2022-08-25;32;0;32;5;N
SANTO ANTONIO DE JESUS;426;EPS;CORTE;2022-08-23;4;4;0;3;N
EUNAPOLIS;98;STC;CORTE;2022-08-08;12;11;1;2;N
PITUBA;356;STC;CORTE;2022-08-04;38;33;5;5;N
VITORIA DA CONQUISTA;500;STC;CORTE;2022-08-15;11;11;0;2;N
JACOBINA;257;EPS;CORTE;2022-08-16;8;8;0;3;N
LUIS EDUARDO MAGALHAES;319;STC;CORTE;2022-08-23;12;10;2;3;N
VALENCA;496;STC;CORTE;2022-08-09;21;20;1;3;N
ITABERABA;215;EPS;RECORTE;2022-08-04;7;7;0;5;N
REMANSO;392;EPS;CORTE;2022-08-23;64;60;4;3;N
ESPLANADA;83;STC;CORTE;2022-08-12;11;11;0;6;N
TEIXEIRA DE FREITAS;480;EPS;DISJUNTOR;2022-08-10;19;16;3;4;N
IRECE;203;STC;CORTE;2022-08-22;20;20;0;2;N
LUIS EDUARDO MAGALHAES;320;STC;CORTE;2022-08-11;11;10;1;5;N
ITABUNA;172;STC;CORTE;2022-08-08;16;16;0;2;N
CAMACARI;52;EPS;RECORTE;2022-08-25;22;15;7;5;N
RIBEIRA DO POMBAL;400;EPS;RECORTE;2022-08-24;20;20;0;4;N
GUANAMBI;139;EPS;BAIXA;2022-08-09;9;5;4;3;N
GRACA;130;STC;CORTE;2022-08-04;17;17;0;5;N
LIVRAMENTO DE NOSSA SENHORA;302;STC;RECORTE;2022-08-17;2;1;1;4;N
BARREIRAS;17;EPS;BAIXA;2022-08-10;1;1;0;4;N
SANTO ANTONIO DE JESUS;427;STC;CORTE;2022-08-25;16;15;1;5;N
TEIXEIRA DE FREITAS;482;STC;RECORTE;2022-08-16;6;4;2;3;S
TEIXEIRA DE FREITAS;479;EPS;DISJUNTOR;2022-08-22;3;2;1;2;N
REMANSO;393;EPS;CORTE;2022-08-11;16;16;0;5;N
SANTO AMARO;422;EPS;DISJUNTOR;2022-08-09;6;5;1;3;N
ALAGOINHAS;1;STC;CORTE;2022-08-25;18;18;0;5;S
LUIS EDUARDO MAGALHAES;319;EPS;CORTE;2022-08-09;7;6;1;3;N
ALAGOINHAS;2;STC;CORTE;2022-08-15;2;2;0;2;N
IBOTIRAMA;155;EPS;CORTE;2022-08-05;12;0;12;6;N
SERRINHA;464;EPS;CORTE;2022-08-05;8;0;8;6;N
ESPLANADA;81;EPS;CORTE;2022-08-22;5;5;0;2;N
IRECE;207;STC;RECORTE;2022-08-24;21;19;2;4;N
PERIPERI;347;EPS;CORTE;2022-08-02;44;42;2;3;N
PIRAJA;352;STC;CORTE;2022-08-08;17;15;2;2;N
PERIPERI;348;STC;CORTE;2022-08-04;14;13;1;5;N
ITABERABA;215;EPS;BAIXA;2022-08-04;23;23;0;5;N
ITAPETINGA;248;STC;CORTE;2022-08-16;9;9;0;3;N
PERIPERI;347;STC;CORTE;2022-08-16;48;47;1;3;N
PIRAJA;350;EPS;CORTE;2022-08-18;14;13;1;5;N
SANTO ANTONIO DE JESUS;428;STC;RECORTE;2022-08-12;15;11;4;6;S
IBOTIRAMA;154;EPS;RECORTE;2022-08-18;5;5;0;5;N
LAURO DE FREITAS;298;EPS;CORTE;2022-08-02;15;14;1;3;N
VITORIA DA CONQUISTA;509;EPS;CORTE;2022-08-16;15;14;1;3;N
SERRINHA;459;EPS;CORTE;2022-08-16;7;7;0;3;N
POSTO DA MATA;386;STC;CORTE;2022-08-16;9;9;0;3;S
BOM JESUS DA LAPA;31;STC;CORTE;2022-08-18;16;16;0;5;N
FEIRA DE SANTANA SUL;122;STC;CORTE;2022-08-02;16;16;0;3;N
PERIPERI;348;STC;CORTE;2022-08-02;20;20;0;3;S
SERRINHA;463;EPS;RECORTE;2022-08-18;7;7;0;5;N
ITABERABA;221;STC;CORTE;2022-08-19;15;15;0;6;N
ITABUNA;233;STC;CORTE;2022-08-12;16;16;0;6;N
LUIS EDUARDO MAGALHAES;319;EPS;RECORTE;2022-08-10;7;6;1;4;N
JUAZEIRO;289;EPS;CORTE;2022-08-10;15;15;0;4;N
REMANSO;390;STC;CORTE;2022-08-12;9;9;0;6;N
SENHOR DO BONFIM;451;EPS;RECORTE;2022-08-03;14;14;0;4;N
ILHEUS;173;EPS;CORTE;2022-08-18;24;23;1;5;N
SANTO ANTONIO DE JESUS;426;EPS;RECORTE;2022-08-24;8;8;0;4;N
JEQUIE;273;EPS;RECORTE;2022-08-24;10;10;0;4;N
REMANSO;392;EPS;RECORTE;2022-08-24;6;6;0;4;N
ITABUNA;172;STC;RECORTE;2022-08-09;16;13;3;3;N
CONCEICAO DO COITE;68;STC;RECORTE;2022-08-09;11;5;6;3;N
ILHEUS;175;STC;CORTE;2022-08-08;12;12;0;2;N
PITUBA;359;EPS;BAIXA;2022-08-04;18;15;3;5;N
JUAZEIRO;290;EPS;BAIXA;2022-08-22;82;53;29;2;N
IRECE;207;EPS;BAIXA;2022-08-10;6;6;0;4;N
LUIS EDUARDO MAGALHAES;323;EPS;BAIXA;2022-08-11;3;3;0;5;N
CAMACARI;51;STC;RECORTE;2022-08-02;16;16;0;3;N
SANTO AMARO;422;EPS;BAIXA;2022-08-25;15;14;1;5;S
JACOBINA;258;EPS;RECORTE;2022-08-05;5;5;0;6;N
SANTA MARIA DA VITORIA;418;STC;CORTE;2022-08-22;8;8;0;2;N
VITORIA DA CONQUISTA;500;STC;RECORTE;2022-08-16;17;10;7;3;N
BRUMADO;46;STC;CORTE;2022-08-08;4;4;0;2;N
IPIAU;526;EPS;CORTE;2022-08-11;8;8;0;5;N
GRACA;133;EPS;BAIXA;2022-08-04;11;7;4;5;N
BOM JESUS DA LAPA;30;EPS;CORTE;2022-08-16;5;5;0;3;N
PIRAJA;354;EPS;DISJUNTOR;2022-08-02;16;16;0;3;N
JEQUIE;269;EPS;CORTE;2022-08-22;1;1;0;2;N
JACOBINA;255;STC;CORTE;2022-08-05;18;0;18;6;N
SENHOR DO BONFIM;445;EPS;CORTE;2022-08-25;10;0;10;5;N
GRACA;134;EPS;CORTE;2022-08-16;21;21;0;3;N
VITORIA DA CONQUISTA;521;STC;CORTE;2022-08-09;11;11;0;3;N
PAULO AFONSO;333;EPS;RECORTE;2022-08-03;3;3;0;4;N
JUAZEIRO;285;EPS;CORTE;2022-08-09;15;12;3;3;N
VALENCA;497;EPS;RECORTE;2022-08-10;13;11;2;4;N
IBOTIRAMA;165;STC;RECORTE;2022-08-23;7;7;0;3;N
SERRINHA;456;EPS;CORTE;2022-08-03;5;5;0;4;N
VITORIA DA CONQUISTA;519;EPS;CORTE;2022-08-19;14;13;1;6;N
ITABERABA;217;STC;CORTE;2022-08-18;42;42;0;5;N
VALENCA;496;EPS;DISJUNTOR;2022-08-04;2;2;0;5;N
IRECE;202;STC;CORTE;2022-08-11;11;11;0;5;N
ALAGOINHAS;1;STC;CORTE;2022-08-02;4;4;0;3;S
POSTO DA MATA;385;EPS;RECORTE;2022-08-17;6;6;0;4;N
JUAZEIRO;289;EPS;RECORTE;2022-08-11;8;8;0;5;N
VALENCA;493;EPS;CORTE;2022-08-08;10;10;0;2;N
JACOBINA;257;EPS;BAIXA;2022-08-17;20;17;3;4;N
IBOTIRAMA;154;EPS;BAIXA;2022-08-18;5;5;0;5;N
ITABUNA;185;EPS;BAIXA;2022-08-11;14;14;0;5;N
FEIRA DE SANTANA NORTE;116;STC;RECORTE;2022-08-11;25;25;0;5;N
CANDEIAS;58;STC;RECORTE;2022-08-11;11;10;1;5;S
JACOBINA;534;EPS;CORTE;2022-08-03;5;5;0;4;N
JEQUIE;266;EPS;CORTE;2022-08-09;22;21;1;3;N
JUAZEIRO;290;STC;RECORTE;2022-08-11;7;6;1;5;S
GUANAMBI;142;EPS;CORTE;2022-08-23;5;5;0;3;N
LAURO DE FREITAS;293;STC;CORTE;2022-08-25;45;45;0;5;S
ITABERABA;217;EPS;CORTE;2022-08-04;6;5;1;5;N
IRECE;201;EPS;CORTE;2022-08-09;14;13;1;3;N
BARREIRAS;21;EPS;CORTE;2022-08-12;6;6;0;6;N
ESPLANADA;80;EPS;CORTE;2022-08-11;14;14;0;5;N
FEIRA DE SANTANA NORTE;112;STC;CORTE;2022-08-09;1;1;0;3;N
JUAZEIRO;286;STC;CORTE;2022-08-11;9;9;0;5;N
PERIPERI;348;STC;RECORTE;2022-08-05;19;0;19;6;N
AMARGOSA;6;STC;CORTE;2022-08-05;18;0;18;6;N
ILHEUS;180;EPS;CORTE;2022-08-08;30;30;0;2;N
BARREIRAS;16;EPS;CORTE;2022-08-23;35;34;1;3;N
ESPLANADA;77;STC;CORTE;2022-08-12;11;11;0;6;N
JACOBINA;260;STC;CORTE;2022-08-19;9;9;0;6;N
ESPLANADA;82;STC;RECORTE;2022-08-02;16;14;2;3;N
FEIRA DE SANTANA SUL;127;STC;CORTE;2022-08-16;2;2;0;3;N
FEIRA DE SANTANA SUL;127;EPS;CORTE;2022-08-02;17;17;0;3;N
IPIAU;188;EPS;CORTE;2022-08-22;7;7;0;2;N
ITAPOAN;251;EPS;CORTE;2022-08-09;24;23;1;3;N
VALENCA;491;EPS;DISJUNTOR;2022-08-15;30;29;1;2;N
FEIRA DE SANTANA SUL;128;STC;CORTE;2022-08-04;17;17;0;5;N
VALENCA;490;STC;CORTE;2022-08-09;17;16;1;3;N
VALENCA;493;STC;RECORTE;2022-08-23;17;15;2;3;N
SEABRA;442;EPS;CORTE;2022-08-02;6;5;1;3;N
PORTO SEGURO;377;EPS;CORTE;2022-08-19;10;10;0;6;N
PORTO SEGURO;363;EPS;CORTE;2022-08-15;18;18;0;2;N
ITAPOAN;252;STC;CORTE;2022-08-11;19;19;0;5;N
JACOBINA;534;EPS;RECORTE;2022-08-04;9;9;0;5;N
IBOTIRAMA;170;EPS;CORTE;2022-08-22;7;6;1;2;N
CONCEICAO DO COITE;71;EPS;DISJUNTOR;2022-08-15;6;6;0;2;N
SENHOR DO BONFIM;452;EPS;CORTE;2022-08-15;11;11;0;2;N
VITORIA DA CONQUISTA;517;STC;CORTE;2022-08-08;11;11;0;2;N
TEIXEIRA DE FREITAS;472;STC;CORTE;2022-08-16;16;15;1;3;N
IRECE;197;EPS;CORTE;2022-08-08;14;13;1;2;N
IRECE;197;STC;CORTE;2022-08-22;21;21;0;2;N
IBOTIRAMA;171;EPS;CORTE;2022-08-10;4;4;0;4;N
ESPLANADA;79;EPS;RECORTE;2022-08-24;4;4;0;4;N
JEQUIE;278;STC;CORTE;2022-08-02;11;11;0;3;N
REMANSO;389;EPS;BAIXA;2022-08-11;14;12;2;5;N
CONCEICAO DO COITE;62;EPS;BAIXA;2022-08-18;2;2;0;5;N
SEABRA;443;STC;CORTE;2022-08-04;10;10;0;5;N
JACOBINA;259;EPS;CORTE;2022-08-17;8;8;0;4;N
LAURO DE FREITAS;296;EPS;BAIXA;2022-08-25;15;13;2;5;S
GUANAMBI;138;EPS;CORTE;2022-08-22;5;4;1;2;N
CAMACARI;50;EPS;CORTE;2022-08-24;19;19;0;4;N
SERRINHA;456;STC;RECORTE;2022-08-18;11;8;3;5;N
IRECE;211;EPS;CORTE;2022-08-12;13;13;0;6;N
BARREIRAS;17;STC;CORTE;2022-08-25;9;9;0;5;N
EUNAPOLIS;105;EPS;CORTE;2022-08-10;5;5;0;4;N
GUANAMBI;142;EPS;RECORTE;2022-08-24;19;19;0;4;N
ALAGOINHAS;1;STC;RECORTE;2022-08-05;9;0;9;6;N
SENHOR DO BONFIM;454;STC;CORTE;2022-08-05;13;0;13;6;N
BOM JESUS DA LAPA;29;EPS;CORTE;2022-08-05;6;0;6;6;N
FEIRA DE SANTANA NORTE;112;STC;RECORTE;2022-08-10;1;0;1;4;N
JUAZEIRO;285;STC;RECORTE;2022-08-24;2;1;1;4;N
VITORIA DA CONQUISTA;509;EPS;BAIXA;2022-08-17;12;0;12;4;N
FEIRA DE SANTANA NORTE;109;EPS;CORTE;2022-08-08;81;79;2;2;N
JUAZEIRO;290;EPS;CORTE;2022-08-23;30;30;0;3;N
PIRAJA;355;EPS;DISJUNTOR;2022-08-15;17;17;0;2;N
IRECE;192;EPS;CORTE;2022-08-19;12;12;0;6;N
SANTO AMARO;424;EPS;CORTE;2022-08-04;26;22;4;5;N
BARREIRAS;16;EPS;RECORTE;2022-08-24;9;8;1;4;N
PORTO SEGURO;377;EPS;DISJUNTOR;2022-08-02;23;21;2;3;N
SEABRA;442;EPS;RECORTE;2022-08-03;5;5;0;4;N
IRECE;206;EPS;CORTE;2022-08-23;20;20;0;3;N
SANTO ANTONIO DE JESUS;9;EPS;CORTE;2022-08-02;12;11;1;3;N
FEIRA DE SANTANA SUL;123;STC;CORTE;2022-08-15;18;17;1;2;N
TEIXEIRA DE FREITAS;482;STC;CORTE;2022-08-17;20;20;0;4;S
ITABUNA;226;EPS;CORTE;2022-08-10;30;27;3;4;N
LIVRAMENTO DE NOSSA SENHORA;302;EPS;CORTE;2022-08-04;5;5;0;5;N
PITUBA;359;STC;CORTE;2022-08-19;19;18;1;6;N
SANTO AMARO;424;STC;CORTE;2022-08-18;16;16;0;5;N
ITAPOAN;251;EPS;RECORTE;2022-08-10;14;10;4;4;N
VITORIA DA CONQUISTA;503;EPS;CORTE;2022-08-16;15;14;1;3;N
ITAPETINGA;242;STC;CORTE;2022-08-16;9;9;0;3;N
SENHOR DO BONFIM;450;STC;CORTE;2022-08-04;13;13;0;5;N
PIRAJA;352;EPS;CORTE;2022-08-19;14;13;1;6;N
SANTO ANTONIO DE JESUS;432;EPS;CORTE;2022-08-02;6;5;1;3;N
GUANAMBI;142;EPS;BAIXA;2022-08-24;1;1;0;4;N
SEABRA;438;STC;CORTE;2022-08-15;11;11;0;2;N
AMARGOSA;5;EPS;BAIXA;2022-08-04;8;8;0;5;N
SEABRA;442;STC;RECORTE;2022-08-17;13;10;3;4;N
LIVRAMENTO DE NOSSA SENHORA;310;STC;CORTE;2022-08-19;3;3;0;6;N
IRECE;207;EPS;CORTE;2022-08-11;13;12;1;5;N
ILHEUS;180;STC;RECORTE;2022-08-23;21;21;0;3;N
IRECE;207;STC;CORTE;2022-08-25;19;19;0;5;N
REMANSO;391;STC;CORTE;2022-08-25;6;6;0;5;N
ITABUNA;225;EPS;CORTE;2022-08-22;8;8;0;2;N
BOM JESUS DA LAPA;24;EPS;CORTE;2022-08-16;5;5;0;3;N
TEIXEIRA DE FREITAS;481;EPS;CORTE;2022-08-17;10;9;1;4;N
FEIRA DE SANTANA SUL;122;STC;CORTE;2022-08-25;8;8;0;5;S
JACOBINA;534;EPS;BAIXA;2022-08-04;5;0;5;5;N
GRACA;133;EPS;CORTE;2022-08-05;49;0;49;6;N
TEIXEIRA DE FREITAS;482;EPS;CORTE;2022-08-05;13;0;13;6;N
AMARGOSA;11;EPS;CORTE;2022-08-05;28;0;28;6;N
PITUBA;359;EPS;CORTE;2022-08-05;21;0;21;6;N
SEABRA;436;EPS;CORTE;2022-08-25;10;0;10;5;N
GUANAMBI;148;EPS;CORTE;2022-08-25;4;0;4;5;N
ITABUNA;185;EPS;CORTE;2022-08-12;17;15;2;6;N
PAULO AFONSO;346;STC;CORTE;2022-08-08;11;11;0;2;N
SANTO ANTONIO DE JESUS;9;EPS;RECORTE;2022-08-03;8;8;0;4;N
SANTO AMARO;419;EPS;CORTE;2022-08-15;21;19;2;2;N
ITAPETINGA;238;STC;CORTE;2022-08-15;9;9;0;2;N
BRUMADO;35;STC;CORTE;2022-08-19;10;10;0;6;N
ALAGOINHAS;1;EPS;CORTE;2022-08-15;30;30;0;2;N
ILHEUS;187;STC;CORTE;2022-08-12;8;7;1;6;N
SANTO AMARO;421;EPS;DISJUNTOR;2022-08-23;4;4;0;3;N
SANTO ANTONIO DE JESUS;432;EPS;RECORTE;2022-08-03;8;8;0;4;N
IRECE;204;STC;CORTE;2022-08-12;11;11;0;6;N
PITUBA;357;EPS;DISJUNTOR;2022-08-12;15;15;0;6;N
LUIS EDUARDO MAGALHAES;318;EPS;CORTE;2022-08-23;8;8;0;3;N
IPIAU;532;STC;CORTE;2022-08-04;13;13;0;5;N
IPIAU;531;EPS;CORTE;2022-08-02;11;11;0;3;N
GRACA;129;EPS;CORTE;2022-08-04;25;21;4;5;N
JACOBINA;259;EPS;BAIXA;2022-08-18;1;1;0;5;N
PAULO AFONSO;331;STC;CORTE;2022-08-16;11;11;0;3;N
ILHEUS;186;EPS;CORTE;2022-08-10;20;19;1;4;N
ITABUNA;227;STC;RECORTE;2022-08-11;18;9;9;5;S
IRECE;208;STC;RECORTE;2022-08-12;18;16;2;6;S
FEIRA DE SANTANA SUL;125;EPS;BAIXA;2022-08-25;80;59;21;5;S
FEIRA DE SANTANA NORTE;106;STC;CORTE;2022-08-09;2;2;0;3;N
SANTO AMARO;422;EPS;DISJUNTOR;2022-08-11;6;5;1;5;N
LIVRAMENTO DE NOSSA SENHORA;302;EPS;RECORTE;2022-08-05;3;3;0;6;N
ESPLANADA;82;EPS;CORTE;2022-08-12;14;13;1;6;N
LUIS EDUARDO MAGALHAES;319;EPS;CORTE;2022-08-11;7;6;1;5;N
VITORIA DA CONQUISTA;513;EPS;CORTE;2022-08-19;14;12;2;6;N
ALAGOINHAS;3;STC;CORTE;2022-08-05;23;0;23;6;N
SANTO AMARO;421;STC;CORTE;2022-08-05;9;0;9;6;N
VALENCA;498;EPS;DISJUNTOR;2022-08-05;7;0;7;6;N
TEIXEIRA DE FREITAS;480;EPS;DISJUNTOR;2022-08-12;2;1;1;6;N
BARREIRAS;22;EPS;CORTE;2022-08-25;5;0;5;5;N
ITAPOAN;252;EPS;CORTE;2022-08-22;140;128;12;2;N
CONCEICAO DO COITE;62;EPS;CORTE;2022-08-19;7;6;1;6;N
PIRAJA;351;EPS;CORTE;2022-08-08;19;19;0;2;N
REMANSO;389;EPS;CORTE;2022-08-12;8;8;0;6;N
SENHOR DO BONFIM;446;EPS;CORTE;2022-08-15;12;12;0;2;N
PERIPERI;347;STC;CORTE;2022-08-18;16;16;0;5;N
PERIPERI;347;EPS;CORTE;2022-08-04;34;33;1;5;N
ITABUNA;234;STC;CORTE;2022-08-02;16;16;0;3;N
ITABERABA;222;STC;CORTE;2022-08-09;11;10;1;3;N
CAMACARI;50;STC;RECORTE;2022-08-16;48;42;6;3;N
BOM JESUS DA LAPA;32;STC;CORTE;2022-08-08;9;9;0;2;N
EUNAPOLIS;97;STC;RECORTE;2022-08-23;21;19;2;3;N
SANTA MARIA DA VITORIA;535;EPS;CORTE;2022-08-04;8;8;0;5;N
LUIS EDUARDO MAGALHAES;316;STC;CORTE;2022-08-12;11;11;0;6;N
BRUMADO;49;EPS;RECORTE;2022-08-10;4;3;1;4;N
CANDEIAS;58;STC;CORTE;2022-08-12;9;9;0;6;S
CANDEIAS;59;STC;CORTE;2022-08-02;13;13;0;3;N
VITORIA DA CONQUISTA;500;EPS;RECORTE;2022-08-04;16;13;3;5;N
FEIRA DE SANTANA SUL;122;STC;CORTE;2022-08-02;20;20;0;3;S
JUAZEIRO;290;EPS;BAIXA;2022-08-24;10;10;0;4;N
PITUBA;358;EPS;BAIXA;2022-08-18;14;10;4;5;N
CONCEICAO DO COITE;64;STC;CORTE;2022-08-09;11;9;2;3;N
FEIRA DE SANTANA SUL;121;EPS;CORTE;2022-08-02;8;7;1;3;N
REMANSO;389;STC;CORTE;2022-08-24;12;12;0;4;S
ALAGOINHAS;2;STC;RECORTE;2022-08-16;6;1;5;3;S
CAMACARI;51;STC;RECORTE;2022-08-04;16;15;1;5;N
ESPLANADA;78;STC;CORTE;2022-08-25;11;11;0;5;N
BOM JESUS DA LAPA;30;EPS;CORTE;2022-08-18;5;4;1;5;N
CAMACARI;55;EPS;CORTE;2022-08-15;22;22;0;2;N
LAURO DE FREITAS;293;EPS;CORTE;2022-08-15;16;15;1;2;N
VITORIA DA CONQUISTA;520;STC;CORTE;2022-08-23;11;11;0;3;N
RIBEIRA DO POMBAL;404;STC;CORTE;2022-08-16;11;11;0;3;N
ITABUNA;228;EPS;CORTE;2022-08-11;13;12;1;5;N
GRACA;134;EPS;CORTE;2022-08-18;21;21;0;5;N
CANDEIAS;58;STC;RECORTE;2022-08-15;16;16;0;2;N
ILHEUS;186;EPS;BAIXA;2022-08-11;19;3;16;5;N
SANTA MARIA DA VITORIA;414;STC;CORTE;2022-08-23;15;15;0;3;N
PAULO AFONSO;402;STC;CORTE;2022-08-23;11;10;1;3;N
PERIPERI;347;EPS;RECORTE;2022-08-05;30;30;0;6;N
PAULO AFONSO;328;EPS;CORTE;2022-08-15;8;8;0;2;N
FEIRA DE SANTANA SUL;122;STC;RECORTE;2022-08-03;7;6;1;4;S
JUAZEIRO;284;EPS;CORTE;2022-08-23;15;15;0;3;N
SERRINHA;455;EPS;CORTE;2022-08-17;7;7;0;4;N
SERRINHA;456;STC;CORTE;2022-08-19;11;11;0;6;N
BOM JESUS DA LAPA;27;STC;CORTE;2022-08-19;16;15;1;6;N
IBOTIRAMA;161;STC;CORTE;2022-08-23;16;16;0;3;N
JACOBINA;264;STC;CORTE;2022-08-22;6;6;0;2;N
CONCEICAO DO COITE;72;EPS;CORTE;2022-08-22;7;6;1;2;N
BARREIRAS;22;EPS;CORTE;2022-08-02;9;8;1;3;N
GRACA;136;STC;CORTE;2022-08-08;17;17;0;2;N
GRACA;129;EPS;BAIXA;2022-08-05;3;2;1;6;N
SANTA MARIA DA VITORIA;535;EPS;RECORTE;2022-08-05;9;9;0;6;N
PIRAJA;352;STC;RECORTE;2022-08-11;17;17;0;5;N
LAURO DE FREITAS;298;EPS;RECORTE;2022-08-05;61;60;1;6;N
PERIPERI;347;STC;RECORTE;2022-08-19;19;15;4;6;N
BRUMADO;49;EPS;BAIXA;2022-08-10;1;1;0;4;N
ITABUNA;228;STC;CORTE;2022-08-25;15;13;2;5;N
PERIPERI;348;STC;RECORTE;2022-08-05;7;4;3;6;S
ITABUNA;227;EPS;CORTE;2022-08-23;22;20;2;3;N
ITABERABA;216;EPS;CORTE;2022-08-18;3;3;0;5;N
SANTO ANTONIO DE JESUS;433;EPS;CORTE;2022-08-15;4;4;0;2;N
ALAGOINHAS;2;EPS;BAIXA;2022-08-04;7;7;0;5;N
VITORIA DA CONQUISTA;520;EPS;CORTE;2022-08-09;15;13;2;3;N
LAURO DE FREITAS;295;STC;CORTE;2022-08-05;16;0;16;6;N
PAULO AFONSO;330;STC;CORTE;2022-08-05;11;0;11;6;N
SERRINHA;456;EPS;CORTE;2022-08-05;8;0;8;6;N
AMARGOSA;5;EPS;CORTE;2022-08-05;28;0;28;6;N
JACOBINA;534;EPS;CORTE;2022-08-05;6;0;6;6;N
FEIRA DE SANTANA NORTE;115;STC;RECORTE;2022-08-25;20;14;6;5;N
ITABUNA;232;STC;RECORTE;2022-08-25;9;7;2;5;S
ILHEUS;180;EPS;CORTE;2022-08-10;87;83;4;4;N
IRECE;198;STC;CORTE;2022-08-12;11;11;0;6;N
SENHOR DO BONFIM;453;STC;CORTE;2022-08-19;11;10;1;6;N
LAURO DE FREITAS;294;EPS;RECORTE;2022-08-04;20;20;0;5;N
PAULO AFONSO;326;STC;CORTE;2022-08-04;11;11;0;5;N
PAULO AFONSO;338;EPS;CORTE;2022-08-18;7;6;1;5;N
GUANAMBI;141;STC;CORTE;2022-08-02;11;10;1;3;N
PAULO AFONSO;325;EPS;CORTE;2022-08-02;10;10;0;3;N
PERIPERI;347;EPS;BAIXA;2022-08-05;26;23;3;6;N
JACOBINA;261;STC;CORTE;2022-08-09;21;21;0;3;N
SANTO ANTONIO DE JESUS;426;EPS;RECORTE;2022-08-03;8;8;0;4;N
IPIAU;189;EPS;CORTE;2022-08-12;8;8;0;6;N
GUANAMBI;142;EPS;DISJUNTOR;2022-08-08;13;13;0;2;N
BARREIRAS;18;STC;CORTE;2022-08-15;15;15;0;2;N
SEABRA;441;EPS;CORTE;2022-08-16;14;14;0;3;N
SEABRA;442;EPS;CORTE;2022-08-04;6;5;1;5;N
JACOBINA;259;EPS;CORTE;2022-08-19;8;7;1;6;N
ITAPOAN;251;EPS;CORTE;2022-08-11;46;42;4;5;N
FEIRA DE SANTANA NORTE;112;STC;RECORTE;2022-08-12;16;11;5;6;N
JEQUIE;278;STC;CORTE;2022-08-04;11;11;0;5;N
ESPLANADA;78;STC;CORTE;2022-08-02;11;11;0;3;N
PORTO SEGURO;369;STC;RECORTE;2022-08-09;16;5;11;3;N
IRECE;202;STC;RECORTE;2022-08-12;15;6;9;6;S
PAULO AFONSO;340;STC;CORTE;2022-08-08;2;2;0;2;N
FEIRA DE SANTANA NORTE;107;STC;CORTE;2022-08-22;20;20;0;2;N
RIBEIRA DO POMBAL;404;STC;RECORTE;2022-08-17;11;7;4;4;N
JACOBINA;264;STC;RECORTE;2022-08-23;16;16;0;3;N
JEQUIE;277;EPS;CORTE;2022-08-02;8;8;0;3;N
VALENCA;489;EPS;CORTE;2022-08-09;8;8;0;3;N
VALENCA;493;STC;RECORTE;2022-08-23;7;1;6;3;S
LIVRAMENTO DE NOSSA SENHORA;305;STC;RECORTE;2022-08-08;6;6;0;2;N
IBOTIRAMA;170;EPS;CORTE;2022-08-24;5;5;0;4;N
ILHEUS;179;EPS;CORTE;2022-08-22;16;16;0;2;N
LAURO DE FREITAS;298;EPS;BAIXA;2022-08-05;18;18;0;6;N
POSTO DA MATA;378;EPS;CORTE;2022-08-04;5;5;0;5;N
GRACA;136;STC;RECORTE;2022-08-09;17;5;12;3;N
SENHOR DO BONFIM;453;EPS;CORTE;2022-08-05;7;0;7;6;N
FEIRA DE SANTANA NORTE;116;EPS;CORTE;2022-08-23;31;29;2;3;N
PIRAJA;353;STC;CORTE;2022-08-23;99;88;11;3;N
JUAZEIRO;292;STC;CORTE;2022-08-15;9;9;0;2;N
FEIRA DE SANTANA SUL;123;EPS;CORTE;2022-08-03;42;42;0;4;N
PIRAJA;353;EPS;CORTE;2022-08-09;17;16;1;3;N
PIRAJA;354;STC;CORTE;2022-08-11;17;16;1;5;N
IRECE;193;STC;CORTE;2022-08-23;42;32;10;3;N
ILHEUS;176;STC;CORTE;2022-08-23;15;15;0;3;N
SANTO AMARO;425;STC;CORTE;2022-08-08;9;9;0;2;N
PAULO AFONSO;401;STC;CORTE;2022-08-12;11;10;1;6;N
IPIAU;188;STC;DISJUNTOR;2022-08-19;36;36;0;6;S
FEIRA DE SANTANA SUL;122;EPS;CORTE;2022-08-15;18;18;0;2;N
JEQUIE;273;STC;CORTE;2022-08-15;11;11;0;2;N
SANTO ANTONIO DE JESUS;8;EPS;CORTE;2022-08-16;4;3;1;3;N
SANTO ANTONIO DE JESUS;432;EPS;CORTE;2022-08-04;6;6;0;5;N
SANTO ANTONIO DE JESUS;9;EPS;CORTE;2022-08-04;12;11;1;5;N
VALENCA;489;EPS;RECORTE;2022-08-10;13;11;2;4;N
SENHOR DO BONFIM;448;EPS;CORTE;2022-08-16;11;9;2;3;N
AMARGOSA;12;STC;CORTE;2022-08-09;16;15;1;3;N
SENHOR DO BONFIM;449;STC;CORTE;2022-08-18;11;11;0;5;N
POSTO DA MATA;387;EPS;CORTE;2022-08-19;7;6;1;6;N
SENHOR DO BONFIM;454;STC;RECORTE;2022-08-08;17;16;1;2;N
IRECE;206;EPS;CORTE;2022-08-23;30;30;0;3;S
ILHEUS;180;STC;RECORTE;2022-08-23;7;6;1;3;S
SENHOR DO BONFIM;449;EPS;CORTE;2022-08-04;7;7;0;5;N
IBOTIRAMA;166;EPS;CORTE;2022-08-23;7;6;1;3;N
IBOTIRAMA;167;STC;CORTE;2022-08-25;14;13;1;5;N
IRECE;193;EPS;CORTE;2022-08-09;42;40;2;3;N
GUANAMBI;151;STC;CORTE;2022-08-05;10;0;10;6;N
SEABRA;439;STC;CORTE;2022-08-05;5;0;5;6;N
ILHEUS;179;EPS;DISJUNTOR;2022-08-05;1;0;1;6;N
VITORIA DA CONQUISTA;519;EPS;BAIXA;2022-08-22;7;0;7;2;N
IRECE;203;EPS;CORTE;2022-08-12;13;12;1;6;N
SANTO AMARO;420;STC;CORTE;2022-08-19;21;21;0;6;N
FEIRA DE SANTANA NORTE;106;STC;CORTE;2022-08-11;23;23;0;5;N
SANTO ANTONIO DE JESUS;427;EPS;CORTE;2022-08-15;4;4;0;2;N
PORTO SEGURO;371;STC;CORTE;2022-08-09;16;16;0;3;N
SANTO AMARO;420;STC;CORTE;2022-08-17;20;19;1;4;S
TEIXEIRA DE FREITAS;471;EPS;BAIXA;2022-08-17;12;12;0;4;N
PITUBA;356;STC;CORTE;2022-08-08;38;34;4;2;N
CAMACARI;50;EPS;CORTE;2022-08-03;13;13;0;4;N
ESPLANADA;83;EPS;CORTE;2022-08-02;16;16;0;3;N
IPIAU;531;EPS;CORTE;2022-08-04;11;8;3;5;N
VALENCA;498;EPS;RECORTE;2022-08-25;51;51;0;5;N
RIBEIRA DO POMBAL;399;STC;CORTE;2022-08-04;11;11;0;5;N
ESPLANADA;83;STC;CORTE;2022-08-16;11;11;0;3;N
IRECE;207;EPS;RECORTE;2022-08-12;12;11;1;6;S
BRUMADO;36;STC;CORTE;2022-08-09;11;11;0;3;N
VITORIA DA CONQUISTA;500;STC;CORTE;2022-08-19;11;11;0;6;N
VALENCA;495;EPS;CORTE;2022-08-11;21;21;0;5;N
VALENCA;497;EPS;DISJUNTOR;2022-08-19;13;12;1;6;N
CAMACARI;50;EPS;BAIXA;2022-08-25;16;16;0;5;S
PAULO AFONSO;345;EPS;CORTE;2022-08-08;9;9;0;2;N
SANTO ANTONIO DE JESUS;431;EPS;RECORTE;2022-08-17;6;6;0;4;N
JUAZEIRO;286;EPS;CORTE;2022-08-24;16;14;2;4;N
PORTO SEGURO;369;EPS;CORTE;2022-08-19;10;10;0;6;N
ILHEUS;186;EPS;CORTE;2022-08-12;10;10;0;6;N
IBOTIRAMA;155;EPS;CORTE;2022-08-09;10;10;0;3;N
FEIRA DE SANTANA SUL;126;EPS;BAIXA;2022-08-17;2;1;1;4;N
EUNAPOLIS;97;EPS;CORTE;2022-08-10;6;4;2;4;N
ALAGOINHAS;2;STC;CORTE;2022-08-19;1;1;0;6;N
ITAPETINGA;239;STC;CORTE;2022-08-05;9;0;9;6;N
SANTO ANTONIO DE JESUS;429;STC;CORTE;2022-08-05;4;0;4;6;N
SANTO AMARO;420;EPS;CORTE;2022-08-05;14;0;14;6;N
ALAGOINHAS;2;EPS;CORTE;2022-08-05;34;0;34;6;N
IRECE;193;STC;RECORTE;2022-08-24;42;41;1;4;N
SANTO AMARO;421;EPS;DISJUNTOR;2022-08-25;9;0;9;5;N
GUANAMBI;142;STC;CORTE;2022-08-15;16;14;2;2;N
EUNAPOLIS;93;STC;CORTE;2022-08-23;19;17;2;3;N
CAMACARI;50;EPS;RECORTE;2022-08-04;18;17;1;5;N
ITAPOAN;253;EPS;CORTE;2022-08-12;23;23;0;6;N
CANDEIAS;58;STC;CORTE;2022-08-16;39;38;1;3;N
ITABUNA;234;STC;CORTE;2022-08-04;16;16;0;5;N
REMANSO;390;EPS;CORTE;2022-08-02;14;12;2;3;N
ITAPOAN;252;EPS;CORTE;2022-08-22;70;65;5;2;S
SANTA MARIA DA VITORIA;418;EPS;CORTE;2022-08-12;8;8;0;6;N
LUIS EDUARDO MAGALHAES;317;STC;CORTE;2022-08-02;22;20;2;3;N
CANDEIAS;58;EPS;CORTE;2022-08-02;32;30;2;3;N
IPIAU;526;EPS;CORTE;2022-08-15;16;16;0;2;N
BARREIRAS;16;EPS;RECORTE;2022-08-03;8;8;0;4;N
PAULO AFONSO;340;EPS;CORTE;2022-08-19;8;8;0;6;N
SANTA MARIA DA VITORIA;535;STC;CORTE;2022-08-18;6;6;0;5;S
CONCEICAO DO COITE;67;EPS;RECORTE;2022-08-11;5;4;1;5;N
EUNAPOLIS;94;STC;CORTE;2022-08-11;11;11;0;5;N
CONCEICAO DO COITE;64;STC;CORTE;2022-08-11;11;10;1;5;N
PERIPERI;348;STC;CORTE;2022-08-08;11;11;0;2;N
JEQUIE;271;EPS;CORTE;2022-08-02;15;15;0;3;N
ESPLANADA;79;STC;CORTE;2022-08-15;13;13;0;2;N
EUNAPOLIS;97;EPS;RECORTE;2022-08-11;4;3;1;5;N
GRACA;130;STC;RECORTE;2022-08-09;17;1;16;3;N
JACOBINA;255;STC;CORTE;2022-08-09;16;16;0;3;N
ITAPETINGA;249;STC;CORTE;2022-08-08;9;9;0;2;N
REMANSO;391;STC;CORTE;2022-08-02;14;14;0;3;S
IRECE;193;EPS;BAIXA;2022-08-10;9;6;3;4;N
FEIRA DE SANTANA SUL;122;EPS;BAIXA;2022-08-16;12;11;1;3;N
VALENCA;493;EPS;DISJUNTOR;2022-08-18;13;10;3;5;N
SANTO ANTONIO DE JESUS;428;STC;RECORTE;2022-08-18;20;19;1;5;N
SANTO AMARO;421;STC;RECORTE;2022-08-08;40;40;0;2;N
FEIRA DE SANTANA SUL;128;EPS;CORTE;2022-08-17;17;17;0;4;N
ALAGOINHAS;3;STC;RECORTE;2022-08-08;9;8;1;2;N
IRECE;199;STC;CORTE;2022-08-25;5;5;0;5;N
FEIRA DE SANTANA SUL;123;EPS;BAIXA;2022-08-04;21;11;10;5;N
CONCEICAO DO COITE;63;EPS;CORTE;2022-08-09;7;6;1;3;N
ITAPOAN;254;STC;CORTE;2022-08-12;4;4;0;6;S
BRUMADO;48;EPS;RECORTE;2022-08-24;3;3;0;4;N
RIBEIRA DO POMBAL;408;EPS;CORTE;2022-08-05;13;0;13;6;N
EUNAPOLIS;97;STC;RECORTE;2022-08-25;8;6;2;5;N
ESPLANADA;77;EPS;CORTE;2022-08-25;13;0;13;5;N
JACOBINA;263;EPS;CORTE;2022-08-22;8;8;0;2;N
GRACA;135;EPS;CORTE;2022-08-08;108;106;2;2;N
GUANAMBI;152;STC;CORTE;2022-08-18;21;21;0;5;N
ITABERABA;217;STC;CORTE;2022-08-22;42;40;2;2;N
RIBEIRA DO POMBAL;404;STC;CORTE;2022-08-18;11;11;0;5;N
IPIAU;531;EPS;BAIXA;2022-08-05;5;4;1;6;N
LAURO DE FREITAS;293;EPS;CORTE;2022-08-17;16;16;0;4;N
REMANSO;390;EPS;RECORTE;2022-08-03;8;8;0;4;N
VITORIA DA CONQUISTA;505;EPS;CORTE;2022-08-19;14;14;0;6;N
ITAPETINGA;244;STC;CORTE;2022-08-19;10;10;0;6;N
BOM JESUS DA LAPA;28;STC;CORTE;2022-08-09;11;11;0;3;N
SEABRA;212;EPS;CORTE;2022-08-19;11;10;1;6;N
JEQUIE;267;STC;CORTE;2022-08-15;11;11;0;2;N
SANTO ANTONIO DE JESUS;434;STC;CORTE;2022-08-17;30;30;0;4;S
LAURO DE FREITAS;294;STC;CORTE;2022-08-17;20;20;0;4;S
CAMACARI;55;EPS;CORTE;2022-08-17;21;21;0;4;N
BARREIRAS;22;EPS;CORTE;2022-08-04;7;7;0;5;N
CAMACARI;56;STC;CORTE;2022-08-19;16;15;1;6;N
ITABUNA;233;EPS;RECORTE;2022-08-03;6;6;0;4;N
PAULO AFONSO;341;STC;RECORTE;2022-08-22;11;9;2;2;N
BRUMADO;48;EPS;BAIXA;2022-08-24;2;1;1;4;N
VITORIA DA CONQUISTA;519;EPS;CORTE;2022-08-23;15;15;0;3;N
LAURO DE FREITAS;295;EPS;BAIXA;2022-08-17;20;18;2;4;N
ITABUNA;233;STC;RECORTE;2022-08-17;18;8;10;4;N
PERIPERI;348;STC;RECORTE;2022-08-09;38;13;25;3;N
BRUMADO;41;STC;CORTE;2022-08-23;8;8;0;3;N
PERIPERI;347;STC;RECORTE;2022-08-19;9;7;2;6;S
PAULO AFONSO;402;STC;CORTE;2022-08-25;11;11;0;5;N
CONCEICAO DO COITE;72;EPS;CORTE;2022-08-24;7;7;0;4;N
CAMACARI;50;EPS;BAIXA;2022-08-04;10;9;1;5;N
ITABERABA;217;EPS;CORTE;2022-08-08;6;6;0;2;N
JACOBINA;264;EPS;CORTE;2022-08-10;8;8;0;4;N
CANDEIAS;59;STC;RECORTE;2022-08-05;16;0;16;6;N
BRUMADO;44;EPS;DISJUNTOR;2022-08-05;4;0;4;6;N
LAURO DE FREITAS;294;EPS;CORTE;2022-08-05;19;0;19;6;N
SANTO ANTONIO DE JESUS;434;EPS;CORTE;2022-08-05;12;0;12;6;N
ITABUNA;227;EPS;CORTE;2022-08-25;25;0;25;5;N
ESPLANADA;77;EPS;CORTE;2022-08-02;15;14;1;3;N
JEQUIE;276;EPS;CORTE;2022-08-16;16;15;1;3;N
LUIS EDUARDO MAGALHAES;322;STC;CORTE;2022-08-16;11;11;0;3;N
JACOBINA;260;EPS;CORTE;2022-08-09;9;9;0;3;N
SERRINHA;467;STC;CORTE;2022-08-12;22;22;0;6;N
SERRINHA;456;STC;RECORTE;2022-08-22;11;9;2;2;N
IPIAU;527;EPS;BAIXA;2022-08-04;6;5;1;5;N
CAMACARI;55;EPS;RECORTE;2022-08-18;12;9;3;5;N
GRACA;130;EPS;CORTE;2022-08-19;63;62;1;6;N
JACOBINA;261;STC;CORTE;2022-08-11;37;37;0;5;N
CAMACARI;51;EPS;CORTE;2022-08-16;21;21;0;3;N
PAULO AFONSO;325;STC;CORTE;2022-08-18;16;15;1;5;N
LAURO DE FREITAS;293;EPS;RECORTE;2022-08-18;22;17;5;5;N
ESPLANADA;78;STC;CORTE;2022-08-04;22;22;0;5;N
LUIS EDUARDO MAGALHAES;323;STC;CORTE;2022-08-04;11;11;0;5;N
IBOTIRAMA;157;EPS;CORTE;2022-08-10;5;5;0;4;N
IRECE;197;EPS;CORTE;2022-08-12;13;13;0;6;N
CAMACARI;52;STC;CORTE;2022-08-18;16;15;1;5;N
VITORIA DA CONQUISTA;517;STC;CORTE;2022-08-12;11;11;0;6;N
CAMACARI;52;STC;CORTE;2022-08-16;20;20;0;3;S
JACOBINA;264;EPS;RECORTE;2022-08-11;7;7;0;5;N
PAULO AFONSO;325;EPS;CORTE;2022-08-04;8;7;1;5;N
SANTO ANTONIO DE JESUS;430;STC;CORTE;2022-08-18;13;13;0;5;N
CONCEICAO DO COITE;71;EPS;DISJUNTOR;2022-08-19;6;6;0;6;N
CONCEICAO DO COITE;72;EPS;RECORTE;2022-08-25;6;5;1;5;N
FEIRA DE SANTANA NORTE;110;EPS;RECORTE;2022-08-24;8;5;3;4;N
ITABERABA;217;STC;DISJUNTOR;2022-08-03;20;20;0;4;S
IPIAU;190;STC;CORTE;2022-08-16;13;13;0;3;N
FEIRA DE SANTANA SUL;128;EPS;BAIXA;2022-08-18;3;3;0;5;N
CONCEICAO DO COITE;68;EPS;CORTE;2022-08-23;7;7;0;3;N
GUANAMBI;141;STC;CORTE;2022-08-04;6;6;0;5;N
LAURO DE FREITAS;295;STC;RECORTE;2022-08-08;16;12;4;2;N
FEIRA DE SANTANA NORTE;108;STC;CORTE;2022-08-10;40;37;3;4;S
ITABUNA;172;EPS;CORTE;2022-08-23;23;22;1;3;N
IBOTIRAMA;156;EPS;CORTE;2022-08-22;5;5;0;2;N
PORTO SEGURO;363;EPS;CORTE;2022-08-19;2;2;0;6;N
BARREIRAS;19;STC;CORTE;2022-08-05;6;0;6;6;N
PORTO SEGURO;369;STC;RECORTE;2022-08-09;4;0;4;3;S
FEIRA DE SANTANA NORTE;108;STC;CORTE;2022-08-12;1;1;0;6;N
VITORIA DA CONQUISTA;509;EPS;BAIXA;2022-08-19;18;0;18;6;S
JUAZEIRO;292;EPS;CORTE;2022-08-03;11;11;0;4;N
ILHEUS;178;EPS;DISJUNTOR;2022-08-19;32;27;5;6;N
PIRAJA;352;EPS;CORTE;2022-08-23;39;39;0;3;N
PERIPERI;348;EPS;CORTE;2022-08-19;22;21;1;6;N
PITUBA;359;EPS;CORTE;2022-08-09;20;19;1;3;N
JUAZEIRO;291;EPS;CORTE;2022-08-15;15;15;0;2;N
BOM JESUS DA LAPA;33;STC;CORTE;2022-08-23;16;16;0;3;N
AMARGOSA;11;EPS;CORTE;2022-08-09;18;18;0;3;N
POSTO DA MATA;388;EPS;CORTE;2022-08-09;21;21;0;3;N
PIRAJA;353;EPS;CORTE;2022-08-11;48;45;3;5;N
ILHEUS;179;EPS;RECORTE;2022-08-25;18;18;0;5;N
SANTO AMARO;424;EPS;CORTE;2022-08-08;24;23;1;2;N
BARREIRAS;14;STC;CORTE;2022-08-16;15;15;0;3;N
IRECE;207;EPS;CORTE;2022-08-15;13;13;0;2;N
FEIRA DE SANTANA SUL;122;EPS;CORTE;2022-08-17;18;16;2;4;N
TEIXEIRA DE FREITAS;482;EPS;CORTE;2022-08-09;11;11;0;3;N
ESPLANADA;77;EPS;RECORTE;2022-08-03;8;8;0;4;N
PAULO AFONSO;324;EPS;RECORTE;2022-08-17;9;8;1;4;N
IRECE;193;EPS;CORTE;2022-08-11;39;36;3;5;N
PORTO SEGURO;377;EPS;RECORTE;2022-08-24;16;16;0;4;N
IRECE;211;EPS;RECORTE;2022-08-17;5;5;0;4;N
ITABUNA;227;EPS;CORTE;2022-08-02;16;13;3;3;N
FEIRA DE SANTANA NORTE;110;EPS;BAIXA;2022-08-24;3;3;0;4;N
CAMACARI;55;EPS;BAIXA;2022-08-18;5;5;0;5;N
SANTO ANTONIO DE JESUS;8;EPS;CORTE;2022-08-18;4;4;0;5;N
POSTO DA MATA;379;STC;RECORTE;2022-08-09;17;15;2;3;N
SENHOR DO BONFIM;450;STC;CORTE;2022-08-08;13;9;4;2;N
SEABRA;438;STC;CORTE;2022-08-19;9;8;1;6;N
BRUMADO;38;EPS;CORTE;2022-08-22;6;6;0;2;N
IRECE;193;STC;CORTE;2022-08-25;42;35;7;5;N
PAULO AFONSO;334;EPS;CORTE;2022-08-19;6;6;0;6;N
PORTO SEGURO;373;EPS;CORTE;2022-08-22;2;2;0;2;N
PIRAJA;355;EPS;DISJUNTOR;2022-08-19;26;24;2;6;N
SANTA MARIA DA VITORIA;412;EPS;CORTE;2022-08-12;8;8;0;6;N
LIVRAMENTO DE NOSSA SENHORA;310;EPS;CORTE;2022-08-09;5;5;0;3;N
REMANSO;393;STC;CORTE;2022-08-05;9;0;9;6;N
SEABRA;438;EPS;CORTE;2022-08-05;5;0;5;6;N
IBOTIRAMA;154;STC;CORTE;2022-08-11;9;9;0;5;N
GUANAMBI;150;EPS;CORTE;2022-08-05;7;0;7;6;N
FEIRA DE SANTANA SUL;123;EPS;CORTE;2022-08-05;69;0;69;6;N
FEIRA DE SANTANA SUL;123;STC;CORTE;2022-08-19;1;1;0;6;N
GRACA;134;EPS;BAIXA;2022-08-19;7;0;7;6;S
SANTO AMARO;419;EPS;CORTE;2022-08-19;20;18;2;6;N
PIRAJA;350;STC;CORTE;2022-08-12;17;16;1;6;N
ILHEUS;173;STC;CORTE;2022-08-12;21;21;0;6;N
PITUBA;358;EPS;DISJUNTOR;2022-08-04;12;12;0;5;N
EUNAPOLIS;99;STC;CORTE;2022-08-02;14;13;1;3;N
ESPLANADA;83;STC;CORTE;2022-08-18;11;11;0;5;N
ALAGOINHAS;3;STC;CORTE;2022-08-09;22;21;1;3;N
TEIXEIRA DE FREITAS;480;EPS;DISJUNTOR;2022-08-16;18;17;1;3;N
FEIRA DE SANTANA SUL;122;EPS;RECORTE;2022-08-18;14;11;3;5;N
EUNAPOLIS;87;EPS;RECORTE;2022-08-10;3;3;0;4;N
AMARGOSA;11;EPS;RECORTE;2022-08-10;20;19;1;4;N
ITAPETINGA;238;STC;CORTE;2022-08-19;9;9;0;6;N
IRECE;204;STC;CORTE;2022-08-16;11;11;0;3;N
PITUBA;359;EPS;RECORTE;2022-08-10;33;25;8;4;N
GRACA;129;EPS;CORTE;2022-08-08;27;25;2;2;N
GUANAMBI;146;EPS;CORTE;2022-08-04;7;7;0;5;N
ALAGOINHAS;1;EPS;CORTE;2022-08-19;30;29;1;6;N
SANTO AMARO;421;STC;CORTE;2022-08-09;9;9;0;3;N
PERIPERI;349;STC;RECORTE;2022-08-22;19;16;3;2;N
LIVRAMENTO DE NOSSA SENHORA;310;STC;RECORTE;2022-08-24;17;16;1;4;N
IRECE;192;EPS;RECORTE;2022-08-24;13;13;0;4;N
ILHEUS;175;EPS;RECORTE;2022-08-24;8;8;0;4;N
VITORIA DA CONQUISTA;503;EPS;DISJUNTOR;2022-08-03;16;16;0;4;N
PAULO AFONSO;332;STC;CORTE;2022-08-08;11;10;1;2;N
FEIRA DE SANTANA NORTE;107;EPS;BAIXA;2022-08-11;15;14;1;5;N
FEIRA DE SANTANA SUL;123;STC;RECORTE;2022-08-18;17;5;12;5;S
PITUBA;359;STC;RECORTE;2022-08-22;14;5;9;2;S
ILHEUS;187;STC;CORTE;2022-08-16;12;12;0;3;N
ITAPETINGA;242;STC;RECORTE;2022-08-19;7;4;3;6;S
JUAZEIRO;292;EPS;RECORTE;2022-08-04;11;10;1;5;N
IRECE;205;STC;CORTE;2022-08-04;11;11;0;5;N
REMANSO;392;STC;RECORTE;2022-08-18;11;11;0;5;N
JUAZEIRO;288;STC;CORTE;2022-08-16;8;8;0;3;N
VITORIA DA CONQUISTA;521;EPS;CORTE;2022-08-24;28;28;0;4;N
ESPLANADA;83;EPS;CORTE;2022-08-04;8;8;0;5;N
BRUMADO;35;EPS;CORTE;2022-08-09;6;6;0;3;N
SANTO ANTONIO DE JESUS;428;EPS;CORTE;2022-08-05;12;0;12;6;N
POSTO DA MATA;388;EPS;RECORTE;2022-08-10;4;3;1;4;N
ITAPETINGA;238;EPS;CORTE;2022-08-05;14;0;14;6;N
SANTO AMARO;422;EPS;DISJUNTOR;2022-08-15;3;3;0;2;N
VALENCA;494;EPS;CORTE;2022-08-25;9;0;9;5;N
EUNAPOLIS;92;EPS;CORTE;2022-08-23;14;14;0;3;N
SEABRA;443;EPS;CORTE;2022-08-19;11;11;0;6;N
FEIRA DE SANTANA SUL;128;EPS;CORTE;2022-08-19;16;16;0;6;N
ITAPOAN;252;EPS;CORTE;2022-08-24;12;11;1;4;S
FEIRA DE SANTANA NORTE;116;EPS;CORTE;2022-08-02;24;24;0;3;N
PERIPERI;347;EPS;CORTE;2022-08-08;42;41;1;2;N
ITABUNA;233;EPS;CORTE;2022-08-04;17;16;1;5;N
BARREIRAS;20;STC;CORTE;2022-08-18;21;19;2;5;N
ITAPOAN;254;EPS;CORTE;2022-08-02;23;23;0;3;N
IRECE;200;STC;CORTE;2022-08-15;11;11;0;2;N
EUNAPOLIS;87;EPS;BAIXA;2022-08-10;3;2;1;4;N
ESPLANADA;78;EPS;CORTE;2022-08-15;14;14;0;2;N
ALAGOINHAS;2;STC;RECORTE;2022-08-22;16;12;4;2;N
JEQUIE;273;EPS;BAIXA;2022-08-04;19;18;1;5;N
SANTO AMARO;419;EPS;DISJUNTOR;2022-08-02;2;1;1;3;N
IRECE;204;STC;RECORTE;2022-08-17;21;17;4;4;N
IRECE;192;EPS;BAIXA;2022-08-24;1;1;0;4;N
AMARGOSA;11;EPS;BAIXA;2022-08-10;4;4;0;4;N
JEQUIE;279;STC;CORTE;2022-08-19;11;11;0;6;N
AMARGOSA;7;STC;RECORTE;2022-08-23;17;17;0;3;N
FEIRA DE SANTANA SUL;122;EPS;BAIXA;2022-08-18;6;6;0;5;N
SERRINHA;467;EPS;CORTE;2022-08-23;7;7;0;3;N
BOM JESUS DA LAPA;30;EPS;CORTE;2022-08-22;4;4;0;2;N
IRECE;199;STC;CORTE;2022-08-25;7;7;0;5;S
IPIAU;527;EPS;CORTE;2022-08-05;11;0;11;6;N
ILHEUS;175;EPS;BAIXA;2022-08-24;1;0;1;4;N
IRECE;198;EPS;CORTE;2022-08-25;15;0;15;5;N
CAMACARI;55;EPS;CORTE;2022-08-19;21;21;0;6;N
REMANSO;389;EPS;RECORTE;2022-08-17;8;8;0;4;N
JEQUIE;266;EPS;CORTE;2022-08-15;22;21;1;2;N
ITAPOAN;254;STC;RECORTE;2022-08-17;19;10;9;4;N
CAMACARI;57;STC;CORTE;2022-08-09;9;8;1;3;N
FEIRA DE SANTANA NORTE;116;EPS;RECORTE;2022-08-03;17;16;1;4;N
PORTO SEGURO;375;EPS;CORTE;2022-08-23;18;18;0;3;N
ITAPOAN;252;EPS;DISJUNTOR;2022-08-09;28;28;0;3;N
SANTO ANTONIO DE JESUS;435;STC;CORTE;2022-08-09;19;19;0;3;N
LIVRAMENTO DE NOSSA SENHORA;309;STC;RECORTE;2022-08-11;9;9;0;5;S
VITORIA DA CONQUISTA;506;EPS;CORTE;2022-08-09;15;14;1;3;N
IRECE;209;EPS;CORTE;2022-08-16;10;9;1;3;N
JUAZEIRO;286;EPS;CORTE;2022-08-03;11;11;0;4;N
GRACA;134;EPS;CORTE;2022-08-22;23;22;1;2;N
CONCEICAO DO COITE;74;STC;CORTE;2022-08-16;5;5;0;3;N
JEQUIE;270;EPS;RECORTE;2022-08-17;9;8;1;4;N
ITABUNA;232;EPS;RECORTE;2022-08-17;8;8;0;4;N
ITABUNA;230;STC;CORTE;2022-08-03;20;20;0;4;S
BRUMADO;40;EPS;CORTE;2022-08-23;5;5;0;3;N
PAULO AFONSO;403;STC;CORTE;2022-08-15;11;11;0;2;N
TEIXEIRA DE FREITAS;484;EPS;CORTE;2022-08-10;10;9;1;4;N
GRACA;136;STC;CORTE;2022-08-12;17;15;2;6;N
SANTA MARIA DA VITORIA;418;EPS;RECORTE;2022-08-15;4;4;0;2;N
JACOBINA;264;EPS;CORTE;2022-08-12;9;8;1;6;N
PERIPERI;348;STC;RECORTE;2022-08-11;19;19;0;5;N
SERRINHA;456;EPS;CORTE;2022-08-09;6;6;0;3;N
PAULO AFONSO;345;EPS;BAIXA;2022-08-11;14;14;0;5;N
ITABUNA;230;STC;CORTE;2022-08-05;32;0;32;6;N
GRACA;132;STC;CORTE;2022-08-11;17;17;0;5;N
SANTO AMARO;422;STC;CORTE;2022-08-22;21;21;0;2;N
GRACA;131;EPS;CORTE;2022-08-09;21;20;1;3;N
LUIS EDUARDO MAGALHAES;322;EPS;CORTE;2022-08-04;8;8;0;5;N
JEQUIE;278;STC;CORTE;2022-08-08;11;11;0;2;N
ITAPETINGA;241;STC;CORTE;2022-08-08;9;7;2;2;N
VITORIA DA CONQUISTA;519;EPS;DISJUNTOR;2022-08-08;29;29;0;2;N
LUIS EDUARDO MAGALHAES;322;STC;CORTE;2022-08-18;16;16;0;5;N
SERRINHA;466;EPS;CORTE;2022-08-12;8;8;0;6;N
BOM JESUS DA LAPA;27;EPS;RECORTE;2022-08-10;7;7;0;4;N
IPIAU;189;EPS;CORTE;2022-08-16;8;8;0;3;N
FEIRA DE SANTANA NORTE;107;EPS;CORTE;2022-08-12;58;47;11;6;N
IPIAU;190;EPS;CORTE;2022-08-04;11;11;0;5;N
ITABERABA;213;STC;CORTE;2022-08-23;21;20;1;3;N
ESPLANADA;77;EPS;CORTE;2022-08-04;17;17;0;5;N
JACOBINA;259;EPS;CORTE;2022-08-23;8;8;0;3;N
FEIRA DE SANTANA NORTE;113;STC;RECORTE;2022-08-04;16;16;0;5;N
RIBEIRA DO POMBAL;399;EPS;CORTE;2022-08-17;10;10;0;4;N
CANDEIAS;58;EPS;BAIXA;2022-08-05;28;25;3;6;N
JACOBINA;263;EPS;RECORTE;2022-08-25;8;7;1;5;N
ITABERABA;216;EPS;RECORTE;2022-08-23;1;1;0;3;N
AMARGOSA;5;EPS;RECORTE;2022-08-10;10;8;2;4;N
IPIAU;532;EPS;CORTE;2022-08-19;8;8;0;6;N
IBOTIRAMA;171;EPS;CORTE;2022-08-16;6;4;2;3;N
PAULO AFONSO;326;STC;CORTE;2022-08-08;11;11;0;2;N
ITABUNA;232;EPS;BAIXA;2022-08-17;8;8;0;4;N
GUANAMBI;139;EPS;CORTE;2022-08-16;6;6;0;3;N
ITAPOAN;252;EPS;BAIXA;2022-08-25;15;11;4;5;S
SANTA MARIA DA VITORIA;417;EPS;BAIXA;2022-08-25;3;1;2;5;S
LUIS EDUARDO MAGALHAES;321;EPS;CORTE;2022-08-16;7;7;0;3;N
VITORIA DA CONQUISTA;502;STC;CORTE;2022-08-22;11;11;0;2;N
SENHOR DO BONFIM;453;EPS;CORTE;2022-08-09;6;5;1;3;N
IBOTIRAMA;156;EPS;CORTE;2022-08-24;6;5;1;4;N
ESPLANADA;79;EPS;BAIXA;2022-08-04;6;6;0;5;N
ITABERABA;213;EPS;CORTE;2022-08-09;5;5;0;3;N
BARREIRAS;18;EPS;CORTE;2022-08-05;8;0;8;6;N
ITABERABA;214;STC;CORTE;2022-08-11;11;11;0;5;N
ITABUNA;172;EPS;CORTE;2022-08-25;25;0;25;5;N
FEIRA DE SANTANA SUL;122;EPS;CORTE;2022-08-19;18;18;0;6;N
IRECE;198;EPS;RECORTE;2022-08-03;6;5;1;4;N
SANTO ANTONIO DE JESUS;9;EPS;CORTE;2022-08-08;12;12;0;2;N
AMARGOSA;11;EPS;CORTE;2022-08-11;20;20;0;5;N
CANDEIAS;59;EPS;CORTE;2022-08-17;17;15;2;4;N
ITABUNA;235;STC;CORTE;2022-08-19;16;16;0;6;N
RIBEIRA DO POMBAL;410;STC;CORTE;2022-08-22;11;11;0;2;N
SENHOR DO BONFIM;449;EPS;CORTE;2022-08-08;7;7;0;2;N
VALENCA;490;STC;RECORTE;2022-08-16;17;17;0;3;N
JACOBINA;256;EPS;CORTE;2022-08-10;9;8;1;4;N
IRECE;208;STC;CORTE;2022-08-17;18;18;0;4;S
EUNAPOLIS;87;EPS;CORTE;2022-08-11;5;2;3;5;N
JUAZEIRO;291;EPS;CORTE;2022-08-17;15;14;1;4;N
PIRAJA;354;STC;CORTE;2022-08-15;17;17;0;2;N
REMANSO;392;STC;CORTE;2022-08-17;20;19;1;4;S
BOM JESUS DA LAPA;23;STC;RECORTE;2022-08-23;16;14;2;3;N
ALAGOINHAS;4;STC;RECORTE;2022-08-23;16;16;0;3;N
IRECE;194;STC;CORTE;2022-08-15;10;10;0;2;N
FEIRA DE SANTANA NORTE;109;STC;RECORTE;2022-08-03;1;1;0;4;N
ITABERABA;213;STC;RECORTE;2022-08-24;21;20;1;4;N
IPIAU;189;EPS;RECORTE;2022-08-17;8;7;1;4;N
AMARGOSA;10;EPS;CORTE;2022-08-23;5;5;0;3;N
SENHOR DO BONFIM;449;STC;CORTE;2022-08-22;11;10;1;2;N
JACOBINA;255;EPS;CORTE;2022-08-22;8;8;0;2;N
GRACA;135;EPS;BAIXA;2022-08-11;2;2;0;5;N
BOM JESUS DA LAPA;27;EPS;BAIXA;2022-08-10;2;2;0;4;N
FEIRA DE SANTANA NORTE;106;EPS;RECORTE;2022-08-25;35;35;0;5;N
FEIRA DE SANTANA NORTE;108;STC;RECORTE;2022-08-15;20;18;2;2;N
BRUMADO;39;EPS;CORTE;2022-08-12;8;8;0;6;N
ITAPOAN;253;STC;RECORTE;2022-08-04;8;1;7;5;S
TEIXEIRA DE FREITAS;473;STC;RECORTE;2022-08-09;10;5;5;3;S
PERIPERI;349;EPS;CORTE;2022-08-09;16;16;0;3;N
VITORIA DA CONQUISTA;512;STC;CORTE;2022-08-25;11;11;0;5;N
BOM JESUS DA LAPA;33;STC;CORTE;2022-08-25;16;16;0;5;N
BOM JESUS DA LAPA;32;EPS;CORTE;2022-08-23;4;4;0;3;N
CONCEICAO DO COITE;64;EPS;CORTE;2022-08-24;7;7;0;4;N
IRECE;193;STC;CORTE;2022-08-25;7;7;0;5;S
FEIRA DE SANTANA SUL;124;STC;CORTE;2022-08-09;1;1;0;3;N
IBOTIRAMA;169;STC;CORTE;2022-08-05;9;0;9;6;N
JUAZEIRO;292;EPS;CORTE;2022-08-05;18;0;18;6;N
REMANSO;392;EPS;CORTE;2022-08-05;24;0;24;6;N
SANTO AMARO;425;EPS;BAIXA;2022-08-22;19;0;19;2;N
PIRAJA;352;EPS;CORTE;2022-08-25;12;0;12;5;N
IRECE;192;EPS;CORTE;2022-08-25;12;0;12;5;N
PITUBA;356;STC;CORTE;2022-08-12;38;33;5;6;N
LAURO DE FREITAS;296;EPS;CORTE;2022-08-08;24;23;1;2;N
PAULO AFONSO;331;STC;CORTE;2022-08-22;16;15;1;2;N
PERIPERI;347;EPS;DISJUNTOR;2022-08-16;44;41;3;3;N
LAURO DE FREITAS;296;STC;CORTE;2022-08-22;16;16;0;2;N
IRECE;204;STC;CORTE;2022-08-18;21;21;0;5;N
IPIAU;189;EPS;BAIXA;2022-08-17;4;4;0;4;N
POSTO DA MATA;383;EPS;CORTE;2022-08-22;6;6;0;2;N
SERRINHA;457;EPS;CORTE;2022-08-22;6;6;0;2;N
ITABUNA;172;EPS;CORTE;2022-08-02;16;16;0;3;N
ESPLANADA;82;EPS;CORTE;2022-08-18;13;12;1;5;N
AMARGOSA;6;EPS;CORTE;2022-08-22;5;5;0;2;N
PAULO AFONSO;345;EPS;CORTE;2022-08-12;8;8;0;6;N
VALENCA;495;EPS;CORTE;2022-08-15;19;18;1;2;N
ALAGOINHAS;2;EPS;CORTE;2022-08-09;27;27;0;3;N
FEIRA DE SANTANA NORTE;116;STC;DISJUNTOR;2022-08-22;15;13;2;2;S
AMARGOSA;10;EPS;RECORTE;2022-08-24;25;23;2;4;N
JUAZEIRO;291;EPS;RECORTE;2022-08-18;8;8;0;5;N
ILHEUS;186;EPS;CORTE;2022-08-16;23;20;3;3;N
POSTO DA MATA;385;STC;CORTE;2022-08-12;18;17;1;6;N
ILHEUS;174;STC;CORTE;2022-08-02;9;9;0;3;N
GRACA;130;EPS;BAIXA;2022-08-22;2;2;0;2;N
JUAZEIRO;287;EPS;CORTE;2022-08-16;11;11;0;3;N
IRECE;193;EPS;RECORTE;2022-08-12;12;11;1;6;S
IRECE;203;EPS;CORTE;2022-08-16;10;10;0;3;N
VITORIA DA CONQUISTA;500;EPS;CORTE;2022-08-09;15;15;0;3;N
SANTO AMARO;420;EPS;CORTE;2022-08-09;11;10;1;3;N
ILHEUS;187;EPS;CORTE;2022-08-04;8;0;8;5;N
JUAZEIRO;288;STC;CORTE;2022-08-18;1;1;0;5;N
LIVRAMENTO DE NOSSA SENHORA;305;EPS;CORTE;2022-08-22;2;2;0;2;N
SANTO AMARO;423;EPS;DISJUNTOR;2022-08-05;6;0;6;6;N
PAULO AFONSO;335;STC;RECORTE;2022-08-24;14;14;0;4;N
SENHOR DO BONFIM;454;EPS;CORTE;2022-08-22;20;19;1;2;N
GUANAMBI;142;STC;CORTE;2022-08-19;21;20;1;6;N
ALAGOINHAS;2;EPS;RECORTE;2022-08-10;32;30;2;4;N
VALENCA;492;EPS;CORTE;2022-08-02;18;17;1;3;N
BRUMADO;46;STC;CORTE;2022-08-16;11;11;0;3;N
PAULO AFONSO;328;STC;CORTE;2022-08-09;11;9;2;3;N
IPIAU;526;EPS;CORTE;2022-08-19;8;8;0;6;N
VALENCA;493;EPS;DISJUNTOR;2022-08-22;21;21;0;2;N
ITAPOAN;254;EPS;CORTE;2022-08-04;23;22;1;5;N
BARREIRAS;21;STC;CORTE;2022-08-08;13;12;1;2;N
PAULO AFONSO;407;EPS;CORTE;2022-08-04;7;6;1;5;N
ESPLANADA;79;STC;CORTE;2022-08-19;13;12;1;6;N
ALAGOINHAS;2;STC;RECORTE;2022-08-22;8;8;0;2;S
SANTO AMARO;420;EPS;RECORTE;2022-08-10;14;14;0;4;N
IRECE;199;EPS;CORTE;2022-08-15;11;10;1;2;N
ITAPOAN;253;EPS;CORTE;2022-08-16;19;16;3;3;N
ILHEUS;186;EPS;RECORTE;2022-08-17;9;8;1;4;N
BRUMADO;46;EPS;CORTE;2022-08-02;6;6;0;3;N
LAURO DE FREITAS;296;STC;RECORTE;2022-08-23;16;12;4;3;N
LAURO DE FREITAS;297;STC;RECORTE;2022-08-11;16;16;0;5;N
PAULO AFONSO;340;EPS;CORTE;2022-08-23;8;8;0;3;N
CANDEIAS;59;EPS;BAIXA;2022-08-18;4;4;0;5;N
JEQUIE;278;EPS;CORTE;2022-08-19;14;12;2;6;N
IRECE;203;EPS;RECORTE;2022-08-17;5;5;0;4;N
SEABRA;444;EPS;CORTE;2022-08-09;5;5;0;3;N
RIBEIRA DO POMBAL;409;EPS;BAIXA;2022-08-19;17;0;17;6;S
VITORIA DA CONQUISTA;521;EPS;CORTE;2022-08-03;22;21;1;4;N
SEABRA;440;STC;CORTE;2022-08-22;21;21;0;2;N
ITAPOAN;251;EPS;DISJUNTOR;2022-08-23;16;16;0;3;N
GRACA;137;STC;CORTE;2022-08-02;34;30;4;3;N
SANTO ANTONIO DE JESUS;434;STC;CORTE;2022-08-23;19;18;1;3;N
ITAPETINGA;244;STC;CORTE;2022-08-23;11;11;0;3;N
GUANAMBI;138;STC;CORTE;2022-08-18;21;21;0;5;N
GUANAMBI;152;STC;CORTE;2022-08-22;21;21;0;2;N
RIBEIRA DO POMBAL;404;STC;CORTE;2022-08-22;11;11;0;2;N
BRUMADO;42;STC;CORTE;2022-08-15;11;11;0;2;N
FEIRA DE SANTANA SUL;125;STC;CORTE;2022-08-22;1;1;0;2;N
SANTO ANTONIO DE JESUS;435;STC;CORTE;2022-08-11;19;18;1;5;N
PAULO AFONSO;402;EPS;CORTE;2022-08-15;8;8;0;2;N
ITAPOAN;252;EPS;DISJUNTOR;2022-08-11;30;29;1;5;N
SENHOR DO BONFIM;451;STC;CORTE;2022-08-23;11;11;0;3;N
SEABRA;444;EPS;RECORTE;2022-08-10;3;3;0;4;N
SANTO ANTONIO DE JESUS;434;EPS;CORTE;2022-08-09;10;10;0;3;N
BOM JESUS DA LAPA;27;EPS;CORTE;2022-08-11;5;5;0;5;N
IBOTIRAMA;162;EPS;CORTE;2022-08-03;3;3;0;4;N
ITAPOAN;253;EPS;RECORTE;2022-08-17;19;14;5;4;N
IRECE;203;EPS;BAIXA;2022-08-17;6;6;0;4;N
ALAGOINHAS;2;EPS;BAIXA;2022-08-10;5;5;0;4;N
BRUMADO;46;EPS;RECORTE;2022-08-03;4;4;0;4;N
VITORIA DA CONQUISTA;521;EPS;BAIXA;2022-08-25;28;26;2;5;S
CANDEIAS;58;STC;RECORTE;2022-08-19;5;3;2;6;S
ITABERABA;217;EPS;CORTE;2022-08-12;5;5;0;6;N
CONCEICAO DO COITE;64;STC;RECORTE;2022-08-16;11;10;1;3;N
IRECE;211;STC;CORTE;2022-08-08;11;11;0;2;N
ITAPETINGA;245;STC;CORTE;2022-08-11;9;9;0;5;N
GUANAMBI;142;STC;RECORTE;2022-08-18;8;7;1;5;S
VITORIA DA CONQUISTA;506;STC;CORTE;2022-08-25;10;10;0;5;N
BRUMADO;44;EPS;DISJUNTOR;2022-08-09;5;3;2;3;N
PAULO AFONSO;338;STC;CORTE;2022-08-12;7;7;0;6;N
ITAPOAN;251;STC;CORTE;2022-08-05;19;0;19;6;N
ITABUNA;229;EPS;CORTE;2022-08-05;8;0;8;6;N
ILHEUS;186;EPS;BAIXA;2022-08-17;10;0;10;4;N
PORTO SEGURO;375;EPS;CORTE;2022-08-25;7;0;7;5;N
CAMACARI;52;EPS;CORTE;2022-08-08;25;25;0;2;N
GRACA;130;EPS;CORTE;2022-08-23;66;62;4;3;N
PAULO AFONSO;325;EPS;CORTE;2022-08-08;10;9;1;2;N
GRACA;131;EPS;CORTE;2022-08-11;21;19;2;5;N
PITUBA;359;EPS;DISJUNTOR;2022-08-19;19;19;0;6;N
SANTO ANTONIO DE JESUS;430;STC;CORTE;2022-08-22;13;12;1;2;N
JEQUIE;281;EPS;RECORTE;2022-08-10;9;9;0;4;N
VITORIA DA CONQUISTA;521;EPS;RECORTE;2022-08-04;16;14;2;5;N
PITUBA;356;EPS;CORTE;2022-08-23;34;30;4;3;N
VITORIA DA CONQUISTA;517;STC;CORTE;2022-08-16;10;10;0;3;N
SANTA MARIA DA VITORIA;411;STC;CORTE;2022-08-16;11;10;1;3;N
LUIS EDUARDO MAGALHAES;323;STC;CORTE;2022-08-08;11;11;0;2;N
VITORIA DA CONQUISTA;519;EPS;DISJUNTOR;2022-08-10;25;22;3;4;N
PORTO SEGURO;377;STC;RECORTE;2022-08-16;21;19;2;3;N
SERRINHA;467;EPS;CORTE;2022-08-02;5;5;0;3;N
IRECE;198;EPS;CORTE;2022-08-04;9;8;1;5;N
VITORIA DA CONQUISTA;502;EPS;CORTE;2022-08-10;30;29;1;4;N
ITABUNA;225;EPS;CORTE;2022-08-04;8;8;0;5;N
CAMACARI;52;STC;CORTE;2022-08-22;16;16;0;2;N
ITAPETINGA;240;STC;CORTE;2022-08-22;11;10;1;2;N
ALAGOINHAS;3;EPS;CORTE;2022-08-22;10;9;1;2;N
ITAPOAN;253;EPS;BAIXA;2022-08-17;19;11;8;4;N
LUIS EDUARDO MAGALHAES;321;EPS;CORTE;2022-08-18;7;7;0;5;N
TEIXEIRA DE FREITAS;470;STC;RECORTE;2022-08-23;17;15;2;3;N
VALENCA;490;EPS;BAIXA;2022-08-25;20;19;1;5;S
IBOTIRAMA;159;STC;CORTE;2022-08-04;9;9;0;5;N
FEIRA DE SANTANA NORTE;112;STC;RECORTE;2022-08-18;21;18;3;5;N
PITUBA;357;STC;CORTE;2022-08-25;19;18;1;5;N
ITABERABA;213;EPS;CORTE;2022-08-11;5;5;0;5;N
VITORIA DA CONQUISTA;501;EPS;CORTE;2022-08-22;10;9;1;2;N
RIBEIRA DO POMBAL;399;EPS;CORTE;2022-08-19;10;9;1;6;N
ITABERABA;217;STC;RECORTE;2022-08-25;4;1;3;5;S
IRECE;193;EPS;CORTE;2022-08-15;39;37;2;2;N
CAMACARI;50;EPS;DISJUNTOR;2022-08-15;30;30;0;2;N
SERRINHA;463;STC;CORTE;2022-08-15;11;11;0;2;N
ITAPETINGA;249;EPS;CORTE;2022-08-23;7;7;0;3;N
JEQUIE;274;STC;CORTE;2022-08-09;11;9;2;3;N
PIRAJA;353;EPS;CORTE;2022-08-15;16;16;0;2;N
SENHOR DO BONFIM;450;STC;CORTE;2022-08-12;13;11;2;6;N
FEIRA DE SANTANA NORTE;108;STC;RECORTE;2022-08-17;15;9;6;4;N
PERIPERI;349;EPS;CORTE;2022-08-11;15;12;3;5;N
REMANSO;393;STC;CORTE;2022-08-09;9;9;0;3;N
VALENCA;486;EPS;CORTE;2022-08-02;9;9;0;3;N
PERIPERI;348;EPS;CORTE;2022-08-23;22;22;0;3;N
RIBEIRA DO POMBAL;409;EPS;CORTE;2022-08-22;10;9;1;2;N
JUAZEIRO;291;EPS;CORTE;2022-08-19;15;15;0;6;N
FEIRA DE SANTANA SUL;123;EPS;CORTE;2022-08-09;57;52;5;3;N
ITABERABA;224;STC;CORTE;2022-08-16;11;10;1;3;N
JACOBINA;261;STC;RECORTE;2022-08-16;16;15;1;3;N
CAMACARI;52;STC;RECORTE;2022-08-23;26;24;2;3;N
IRECE;197;EPS;RECORTE;2022-08-17;5;4;1;4;N
IBOTIRAMA;167;EPS;CORTE;2022-08-17;7;7;0;4;N
JACOBINA;256;EPS;CORTE;2022-08-12;9;9;0;6;N
REMANSO;391;EPS;CORTE;2022-08-19;21;17;4;6;N
CANDEIAS;59;EPS;CORTE;2022-08-19;20;20;0;6;N
LUIS EDUARDO MAGALHAES;318;STC;CORTE;2022-08-19;8;8;0;6;N
PORTO SEGURO;375;EPS;CORTE;2022-08-02;16;12;4;3;N
BARREIRAS;13;EPS;CORTE;2022-08-18;7;7;0;5;N
LUIS EDUARDO MAGALHAES;323;STC;RECORTE;2022-08-09;13;11;2;3;N
JACOBINA;255;EPS;CORTE;2022-08-24;8;8;0;4;N
PERIPERI;349;STC;CORTE;2022-08-25;16;16;0;5;N
CONCEICAO DO COITE;67;EPS;DISJUNTOR;2022-08-22;6;6;0;2;N
FEIRA DE SANTANA NORTE;112;EPS;BAIXA;2022-08-04;8;7;1;5;N
ILHEUS;180;EPS;RECORTE;2022-08-17;9;9;0;4;N
PIRAJA;355;STC;CORTE;2022-08-05;17;0;17;6;N
IRECE;195;STC;CORTE;2022-08-05;11;0;11;6;N
IBOTIRAMA;168;EPS;CORTE;2022-08-05;6;0;6;6;N
SANTO AMARO;422;STC;RECORTE;2022-08-25;21;12;9;5;N
TEIXEIRA DE FREITAS;469;EPS;BAIXA;2022-08-19;28;0;28;6;S
LIVRAMENTO DE NOSSA SENHORA;309;EPS;CORTE;2022-08-25;6;0;6;5;N
PIRAJA;350;EPS;CORTE;2022-08-02;23;22;1;3;N
LAURO DE FREITAS;296;EPS;CORTE;2022-08-10;17;17;0;4;N
IRECE;205;STC;CORTE;2022-08-08;11;11;0;2;N
PERIPERI;347;EPS;DISJUNTOR;2022-08-18;58;56;2;5;N
SENHOR DO BONFIM;445;STC;CORTE;2022-08-23;11;10;1;3;N
POSTO DA MATA;378;EPS;BAIXA;2022-08-11;11;8;3;5;N
ILHEUS;173;EPS;CORTE;2022-08-02;15;14;1;3;N
ILHEUS;173;STC;CORTE;2022-08-16;21;21;0;3;N
ITABERABA;224;STC;RECORTE;2022-08-17;21;17;4;4;N
SERRINHA;458;EPS;CORTE;2022-08-12;18;17;1;6;N
LIVRAMENTO DE NOSSA SENHORA;306;EPS;CORTE;2022-08-12;5;5;0;6;N
ITABUNA;172;EPS;CORTE;2022-08-04;17;17;0;5;N
FEIRA DE SANTANA NORTE;113;EPS;CORTE;2022-08-16;39;39;0;3;N
VITORIA DA CONQUISTA;513;STC;RECORTE;2022-08-16;17;14;3;3;N
JACOBINA;255;EPS;RECORTE;2022-08-25;8;6;2;5;N
ILHEUS;186;EPS;CORTE;2022-08-18;13;13;0;5;N
RIBEIRA DO POMBAL;409;EPS;RECORTE;2022-08-23;18;15;3;3;N
SANTO AMARO;419;EPS;CORTE;2022-08-23;20;18;2;3;N
IBOTIRAMA;163;EPS;CORTE;2022-08-16;7;7;0;3;N
IRECE;203;EPS;CORTE;2022-08-18;16;15;1;5;N
JEQUIE;282;EPS;CORTE;2022-08-22;4;4;0;2;N
CANDEIAS;533;EPS;DISJUNTOR;2022-08-03;4;4;0;4;N
ESPLANADA;83;EPS;CORTE;2022-08-08;8;7;1;2;N
SERRINHA;463;STC;RECORTE;2022-08-16;9;8;1;3;N
PERIPERI;349;STC;RECORTE;2022-08-24;64;53;11;4;S
IBOTIRAMA;156;EPS;BAIXA;2022-08-25;14;14;0;5;S
SANTO AMARO;420;EPS;CORTE;2022-08-11;10;10;0;5;N
SENHOR DO BONFIM;449;STC;RECORTE;2022-08-23;4;3;1;3;S
JACOBINA;258;STC;RECORTE;2022-08-03;1;1;0;4;N
FEIRA DE SANTANA SUL;124;STC;RECORTE;2022-08-12;16;12;4;6;N
JUAZEIRO;289;STC;CORTE;2022-08-08;2;2;0;2;N
PAULO AFONSO;324;EPS;BAIXA;2022-08-19;12;0;12;6;S
GRACA;136;EPS;CORTE;2022-08-25;21;0;21;5;N
JACOBINA;263;STC;CORTE;2022-08-16;17;17;0;3;N
PORTO SEGURO;368;STC;CORTE;2022-08-02;11;11;0;3;N
LAURO DE FREITAS;296;EPS;RECORTE;2022-08-11;26;25;1;5;N
VITORIA DA CONQUISTA;520;EPS;DISJUNTOR;2022-08-23;30;30;0;3;N
SENHOR DO BONFIM;445;EPS;RECORTE;2022-08-10;6;5;1;4;N
FEIRA DE SANTANA SUL;128;EPS;CORTE;2022-08-23;18;16;2;3;N
JUAZEIRO;284;STC;CORTE;2022-08-19;14;14;0;6;N
BOM JESUS DA LAPA;23;STC;RECORTE;2022-08-02;11;11;0;3;N
JACOBINA;264;STC;CORTE;2022-08-04;10;9;1;5;N
IRECE;200;STC;CORTE;2022-08-19;6;6;0;6;N
ILHEUS;183;EPS;CORTE;2022-08-05;32;20;12;6;N
SERRINHA;468;EPS;CORTE;2022-08-15;12;12;0;2;N
CONCEICAO DO COITE;64;EPS;CORTE;2022-08-03;6;6;0;4;N
VALENCA;491;EPS;CORTE;2022-08-16;13;13;0;3;N
BOM JESUS DA LAPA;32;EPS;CORTE;2022-08-02;7;7;0;3;N
BARREIRAS;20;STC;CORTE;2022-08-22;21;20;1;2;N
CONCEICAO DO COITE;72;STC;CORTE;2022-08-18;11;11;0;5;N
ILHEUS;183;STC;CORTE;2022-08-17;20;20;0;4;S
PORTO SEGURO;371;STC;RECORTE;2022-08-16;16;16;0;3;N
ALAGOINHAS;1;EPS;RECORTE;2022-08-24;76;73;3;4;N
ESPLANADA;78;EPS;CORTE;2022-08-19;13;13;0;6;N
VALENCA;492;EPS;CORTE;2022-08-04;15;15;0;5;N
PAULO AFONSO;328;STC;CORTE;2022-08-11;11;11;0;5;N
LAURO DE FREITAS;293;STC;CORTE;2022-08-11;16;16;0;5;N
BARREIRAS;20;EPS;CORTE;2022-08-08;10;10;0;2;N
IPIAU;527;EPS;CORTE;2022-08-09;8;8;0;3;N
SANTO AMARO;419;EPS;RECORTE;2022-08-24;21;16;5;4;N
SENHOR DO BONFIM;449;EPS;BAIXA;2022-08-11;20;17;3;5;N
ALAGOINHAS;4;STC;RECORTE;2022-08-02;9;9;0;3;N
CONCEICAO DO COITE;73;EPS;DISJUNTOR;2022-08-24;7;6;1;4;N
PORTO SEGURO;366;EPS;CORTE;2022-08-12;8;7;1;6;N
EUNAPOLIS;95;STC;CORTE;2022-08-05;11;0;11;6;N
POSTO DA MATA;384;EPS;RECORTE;2022-08-11;1;0;1;5;S
PAULO AFONSO;340;EPS;CORTE;2022-08-25;8;0;8;5;N
IPIAU;527;EPS;RECORTE;2022-08-10;8;7;1;4;N
PIRAJA;355;EPS;CORTE;2022-08-16;15;13;2;3;N
SENHOR DO BONFIM;450;EPS;CORTE;2022-08-23;20;20;0;3;N
BOM JESUS DA LAPA;28;STC;CORTE;2022-08-15;10;10;0;2;N
FEIRA DE SANTANA SUL;125;EPS;CORTE;2022-08-10;18;17;1;4;N
SANTA MARIA DA VITORIA;414;EPS;CORTE;2022-08-17;40;39;1;4;N
ITABUNA;230;STC;CORTE;2022-08-09;16;16;0;3;N
ITAPOAN;253;EPS;RECORTE;2022-08-19;30;24;6;6;N
VALENCA;491;EPS;RECORTE;2022-08-17;16;16;0;4;N
CONCEICAO DO COITE;64;EPS;RECORTE;2022-08-04;6;6;0;5;N
PAULO AFONSO;403;STC;CORTE;2022-08-19;11;11;0;6;N
FEIRA DE SANTANA SUL;124;EPS;CORTE;2022-08-22;18;18;0;2;N
GRACA;136;EPS;CORTE;2022-08-02;25;23;2;3;N
SERRINHA;465;STC;CORTE;2022-08-16;11;11;0;3;N
BARREIRAS;20;STC;RECORTE;2022-08-23;21;17;4;3;N
TEIXEIRA DE FREITAS;485;EPS;CORTE;2022-08-02;11;11;0;3;N
SEABRA;439;EPS;CORTE;2022-08-22;10;10;0;2;N
EUNAPOLIS;90;STC;CORTE;2022-08-16;11;10;1;3;N
ITABUNA;233;EPS;RECORTE;2022-08-09;14;3;11;3;N
RIBEIRA DO POMBAL;405;EPS;BAIXA;2022-08-22;12;11;1;2;N
SANTO ANTONIO DE JESUS;433;EPS;CORTE;2022-08-23;4;4;0;3;N
BRUMADO;44;EPS;DISJUNTOR;2022-08-11;6;6;0;5;N
JEQUIE;275;STC;CORTE;2022-08-22;11;11;0;2;N
SANTO ANTONIO DE JESUS;434;EPS;CORTE;2022-08-11;10;8;2;5;N
TEIXEIRA DE FREITAS;470;EPS;CORTE;2022-08-10;10;9;1;4;N
SENHOR DO BONFIM;451;STC;CORTE;2022-08-25;11;11;0;5;N
CONCEICAO DO COITE;64;STC;RECORTE;2022-08-16;10;8;2;3;S
IRECE;200;STC;RECORTE;2022-08-18;4;4;0;5;S
TEIXEIRA DE FREITAS;469;EPS;CORTE;2022-08-22;6;6;0;2;N
IBOTIRAMA;171;STC;CORTE;2022-08-08;5;5;0;2;N
SANTA MARIA DA VITORIA;415;EPS;CORTE;2022-08-05;6;0;6;6;N
FEIRA DE SANTANA NORTE;112;EPS;CORTE;2022-08-05;23;0;23;6;N
ITAPOAN;251;EPS;DISJUNTOR;2022-08-25;60;0;60;5;N
ALAGOINHAS;4;EPS;CORTE;2022-08-12;19;17;2;6;N
BOM JESUS DA LAPA;25;STC;CORTE;2022-08-02;11;11;0;3;N
POSTO DA MATA;378;EPS;CORTE;2022-08-12;13;11;2;6;N
JACOBINA;261;EPS;CORTE;2022-08-03;7;7;0;4;N
CONCEICAO DO COITE;70;STC;CORTE;2022-08-17;12;12;0;4;S
BOM JESUS DA LAPA;23;EPS;CORTE;2022-08-12;5;5;0;6;N
SEABRA;436;STC;CORTE;2022-08-23;19;18;1;3;N
BRUMADO;39;STC;CORTE;2022-08-04;11;11;0;5;N
RIBEIRA DO POMBAL;404;EPS;RECORTE;2022-08-11;9;7;2;5;N
GRACA;136;EPS;RECORTE;2022-08-03;38;37;1;4;N
CAMACARI;52;EPS;CORTE;2022-08-10;73;67;6;4;N
IRECE;205;EPS;CORTE;2022-08-19;16;15;1;6;N
FEIRA DE SANTANA NORTE;108;EPS;CORTE;2022-08-04;54;51;3;5;N
ITAPOAN;250;STC;RECORTE;2022-08-18;14;11;3;5;S
SANTO AMARO;422;EPS;CORTE;2022-08-12;22;20;2;6;N
BRUMADO;38;STC;CORTE;2022-08-16;10;10;0;3;N
ITABERABA;214;STC;CORTE;2022-08-15;11;11;0;2;N
CAMACARI;53;STC;CORTE;2022-08-12;16;13;3;6;N
CONCEICAO DO COITE;64;EPS;BAIXA;2022-08-04;5;3;2;5;N
ITAPETINGA;241;STC;CORTE;2022-08-12;9;8;1;6;N
RIBEIRA DO POMBAL;400;EPS;CORTE;2022-08-09;11;11;0;3;N
FEIRA DE SANTANA NORTE;107;EPS;CORTE;2022-08-16;24;23;1;3;N
JACOBINA;260;EPS;CORTE;2022-08-15;9;9;0;2;N
LUIS EDUARDO MAGALHAES;322;EPS;CORTE;2022-08-08;10;10;0;2;N
TEIXEIRA DE FREITAS;471;STC;RECORTE;2022-08-11;18;11;7;5;S
ITAPOAN;251;STC;RECORTE;2022-08-08;19;11;8;2;N
IPIAU;532;EPS;CORTE;2022-08-23;7;6;1;3;N
BOM JESUS DA LAPA;28;STC;RECORTE;2022-08-16;11;11;0;3;N
ILHEUS;179;STC;RECORTE;2022-08-19;15;8;7;6;N
ITAPETINGA;240;STC;CORTE;2022-08-22;18;17;1;2;S
FEIRA DE SANTANA NORTE;108;STC;CORTE;2022-08-18;1;1;0;5;N
GRACA;130;EPS;CORTE;2022-08-25;21;0;21;5;N
PITUBA;356;EPS;CORTE;2022-08-25;28;0;28;5;N
LUIS EDUARDO MAGALHAES;317;EPS;CORTE;2022-08-19;7;7;0;6;N
GRACA;129;STC;CORTE;2022-08-02;51;43;8;3;N
SANTO ANTONIO DE JESUS;426;STC;CORTE;2022-08-23;26;26;0;3;N
ITABUNA;236;STC;CORTE;2022-08-11;14;14;0;5;N
TEIXEIRA DE FREITAS;479;EPS;DISJUNTOR;2022-08-08;25;25;0;2;N
REMANSO;392;EPS;CORTE;2022-08-09;27;27;0;3;N
TEIXEIRA DE FREITAS;469;EPS;BAIXA;2022-08-23;17;17;0;3;N
PORTO SEGURO;377;EPS;BAIXA;2022-08-04;12;9;3;5;N
JACOBINA;257;EPS;CORTE;2022-08-02;9;9;0;3;N
SERRINHA;462;EPS;CORTE;2022-08-15;12;11;1;2;N
JACOBINA;261;EPS;RECORTE;2022-08-04;9;8;1;5;N
JACOBINA;258;STC;CORTE;2022-08-04;17;16;1;5;N
ESPLANADA;81;STC;CORTE;2022-08-22;11;11;0;2;N
BARREIRAS;14;EPS;CORTE;2022-08-08;8;8;0;2;N
VALENCA;486;EPS;CORTE;2022-08-04;8;8;0;5;N
CONCEICAO DO COITE;65;EPS;CORTE;2022-08-16;7;7;0;3;N
ITAPETINGA;237;STC;CORTE;2022-08-11;9;9;0;5;N
FEIRA DE SANTANA NORTE;107;EPS;RECORTE;2022-08-17;6;6;0;4;N
JUAZEIRO;292;EPS;CORTE;2022-08-09;15;14;1;3;N
ILHEUS;178;EPS;BAIXA;2022-08-17;10;7;3;4;N
SERRINHA;463;EPS;CORTE;2022-08-03;4;4;0;4;N
ITABERABA;223;EPS;CORTE;2022-08-16;4;4;0;3;N
RIBEIRA DO POMBAL;404;EPS;BAIXA;2022-08-11;6;6;0;5;N
CAMACARI;52;EPS;RECORTE;2022-08-11;24;23;1;5;N
CAMACARI;50;EPS;DISJUNTOR;2022-08-17;28;28;0;4;N
SENHOR DO BONFIM;449;EPS;CORTE;2022-08-12;6;6;0;6;N
CAMACARI;52;STC;RECORTE;2022-08-23;4;3;1;3;S
RIBEIRA DO POMBAL;409;EPS;CORTE;2022-08-24;9;9;0;4;N
PORTO SEGURO;360;EPS;CORTE;2022-08-12;9;9;0;6;N
EUNAPOLIS;87;EPS;CORTE;2022-08-15;8;8;0;2;N
LUIS EDUARDO MAGALHAES;319;STC;CORTE;2022-08-09;11;10;1;3;N
IPIAU;532;EPS;RECORTE;2022-08-24;8;8;0;4;N
PIRAJA;354;EPS;CORTE;2022-08-05;17;0;17;6;N
ILHEUS;177;EPS;CORTE;2022-08-05;12;0;12;6;N
SANTA MARIA DA VITORIA;536;EPS;CORTE;2022-08-25;2;0;2;5;N
PERIPERI;348;EPS;CORTE;2022-08-25;26;0;26;5;N
LAURO DE FREITAS;298;STC;CORTE;2022-08-02;32;31;1;3;N
LAURO DE FREITAS;295;EPS;CORTE;2022-08-24;14;12;2;4;N
PERIPERI;347;STC;CORTE;2022-08-02;48;44;4;3;N
GRACA;137;EPS;CORTE;2022-08-15;63;60;3;2;N
PITUBA;356;EPS;CORTE;2022-08-02;54;50;4;3;N
ILHEUS;178;STC;RECORTE;2022-08-08;21;20;1;2;N
SERRINHA;459;EPS;CORTE;2022-08-02;5;5;0;3;N
ILHEUS;173;STC;CORTE;2022-08-18;21;21;0;5;N
PIRAJA;350;STC;CORTE;2022-08-18;17;17;0;5;N
SENHOR DO BONFIM;445;EPS;CORTE;2022-08-11;6;6;0;5;N
ITABUNA;231;STC;CORTE;2022-08-22;21;21;0;2;N
PITUBA;357;STC;CORTE;2022-08-02;30;29;1;3;S
BOM JESUS DA LAPA;30;STC;CORTE;2022-08-16;11;10;1;3;N
FEIRA DE SANTANA NORTE;115;STC;CORTE;2022-08-08;14;13;1;2;N
EUNAPOLIS;88;EPS;RECORTE;2022-08-04;5;5;0;5;N
CANDEIAS;58;EPS;DISJUNTOR;2022-08-16;24;23;1;3;N
LAURO DE FREITAS;296;EPS;CORTE;2022-08-12;16;16;0;6;N
IBOTIRAMA;154;EPS;RECORTE;2022-08-04;7;6;1;5;N
SERRINHA;463;EPS;RECORTE;2022-08-04;7;6;1;5;N
CONCEICAO DO COITE;75;EPS;CORTE;2022-08-19;7;7;0;6;N
SERRINHA;459;STC;CORTE;2022-08-16;11;11;0;3;N
JEQUIE;273;EPS;RECORTE;2022-08-10;9;9;0;4;N
LAURO DE FREITAS;297;STC;CORTE;2022-08-12;6;6;0;6;S
PIRAJA;350;EPS;CORTE;2022-08-04;14;13;1;5;N
JACOBINA;261;EPS;BAIXA;2022-08-04;5;5;0;5;N
RIBEIRA DO POMBAL;409;EPS;RECORTE;2022-08-25;9;7;2;5;N
SANTO ANTONIO DE JESUS;9;EPS;RECORTE;2022-08-11;25;21;4;5;S
JEQUIE;269;EPS;CORTE;2022-08-08;7;7;0;2;N
IPIAU;532;EPS;BAIXA;2022-08-24;5;2;3;4;N
EUNAPOLIS;99;EPS;BAIXA;2022-08-18;2;2;0;5;N
ITAPETINGA;246;STC;CORTE;2022-08-24;18;18;0;4;S
FEIRA DE SANTANA NORTE;107;EPS;BAIXA;2022-08-17;7;7;0;4;N
SENHOR DO BONFIM;445;STC;CORTE;2022-08-25;10;10;0;5;N
REMANSO;392;EPS;RECORTE;2022-08-10;6;6;0;4;N
RIBEIRA DO POMBAL;405;EPS;CORTE;2022-08-23;9;8;1;3;N
ILHEUS;187;EPS;CORTE;2022-08-08;6;6;0;2;N
ILHEUS;173;EPS;CORTE;2022-08-04;12;0;12;5;N
PAULO AFONSO;333;STC;CORTE;2022-08-02;4;4;0;3;N
EUNAPOLIS;86;EPS;DISJUNTOR;2022-08-10;4;4;0;4;N
PORTO SEGURO;370;EPS;CORTE;2022-08-15;9;8;1;2;N
JACOBINA;263;STC;CORTE;2022-08-18;16;15;1;5;N
PITUBA;356;EPS;RECORTE;2022-08-03;14;12;2;4;N
ITAPOAN;254;EPS;CORTE;2022-08-08;25;23;2;2;N
GUANAMBI;142;STC;CORTE;2022-08-23;21;21;0;3;N
IBOTIRAMA;154;EPS;BAIXA;2022-08-04;7;6;1;5;N
CAMACARI;53;EPS;CORTE;2022-08-23;20;20;0;3;N
JEQUIE;266;STC;CORTE;2022-08-09;8;8;0;3;N
EUNAPOLIS;88;EPS;BAIXA;2022-08-04;4;3;1;5;N
LAURO DE FREITAS;294;EPS;DISJUNTOR;2022-08-19;34;34;0;6;N
ITABERABA;216;STC;CORTE;2022-08-16;22;21;1;3;N
POSTO DA MATA;385;EPS;RECORTE;2022-08-03;6;5;1;4;N
PAULO AFONSO;345;EPS;RECORTE;2022-08-17;8;6;2;4;N
CONCEICAO DO COITE;65;EPS;BAIXA;2022-08-17;10;10;0;4;N
VALENCA;491;EPS;CORTE;2022-08-18;14;13;1;5;N
IBOTIRAMA;160;STC;CORTE;2022-08-19;8;8;0;6;N
LAURO DE FREITAS;298;STC;RECORTE;2022-08-03;16;16;0;4;N
PAULO AFONSO;333;STC;RECORTE;2022-08-03;1;1;0;4;N
JEQUIE;279;EPS;CORTE;2022-08-11;7;7;0;5;N
PIRAJA;350;STC;RECORTE;2022-08-19;17;14;3;6;N
SERRINHA;468;EPS;CORTE;2022-08-17;6;6;0;4;N
GUANAMBI;142;EPS;CORTE;2022-08-09;6;5;1;3;N
JEQUIE;279;STC;CORTE;2022-08-25;10;10;0;5;N
JACOBINA;262;EPS;CORTE;2022-08-16;8;8;0;3;N
JUAZEIRO;285;STC;CORTE;2022-08-09;4;4;0;3;N
POSTO DA MATA;379;EPS;CORTE;2022-08-25;8;0;8;5;N
GRACA;136;EPS;CORTE;2022-08-04;75;66;9;5;N
BARREIRAS;16;STC;CORTE;2022-08-23;42;41;1;3;N
PORTO SEGURO;371;EPS;BAIXA;2022-08-04;3;1;2;5;N
RIBEIRA DO POMBAL;406;STC;CORTE;2022-08-02;11;10;1;3;N
GUANAMBI;138;STC;CORTE;2022-08-22;21;18;3;2;N
PIRAJA;355;EPS;CORTE;2022-08-18;42;42;0;5;N
ITAPOAN;252;EPS;DISJUNTOR;2022-08-15;20;20;0;2;N
ITABUNA;229;EPS;CORTE;2022-08-09;18;15;3;3;N
SEABRA;442;STC;CORTE;2022-08-02;11;9;2;3;N
ITAPOAN;251;STC;CORTE;2022-08-09;19;18;1;3;N
IBOTIRAMA;170;EPS;CORTE;2022-08-08;7;6;1;2;N
GUANAMBI;138;EPS;CORTE;2022-08-08;7;7;0;2;N
VITORIA DA CONQUISTA;506;EPS;CORTE;2022-08-15;14;14;0;2;N
FEIRA DE SANTANA SUL;124;EPS;CORTE;2022-08-24;18;16;2;4;N
GUANAMBI;142;EPS;RECORTE;2022-08-10;11;11;0;4;N
BOM JESUS DA LAPA;27;EPS;CORTE;2022-08-15;5;5;0;2;N
IRECE;211;STC;CORTE;2022-08-12;11;11;0;6;N
BARREIRAS;17;STC;CORTE;2022-08-11;15;15;0;5;N
SERRINHA;468;EPS;RECORTE;2022-08-18;7;5;2;5;N
FEIRA DE SANTANA SUL;125;EPS;CORTE;2022-08-12;18;18;0;6;N
JEQUIE;276;STC;CORTE;2022-08-12;11;11;0;6;N
ILHEUS;178;EPS;CORTE;2022-08-18;24;22;2;5;N
IRECE;195;EPS;CORTE;2022-08-18;16;14;2;5;N
ESPLANADA;79;EPS;RECORTE;2022-08-10;7;7;0;4;N
JEQUIE;274;EPS;CORTE;2022-08-22;4;4;0;2;N
EUNAPOLIS;93;EPS;RECORTE;2022-08-16;20;14;6;3;S
CONCEICAO DO COITE;61;EPS;BAIXA;2022-08-16;7;7;0;3;N
PORTO SEGURO;377;EPS;CORTE;2022-08-05;8;0;8;6;N
JUAZEIRO;285;STC;RECORTE;2022-08-10;1;0;1;4;N
GUANAMBI;142;STC;RECORTE;2022-08-24;21;19;2;4;N
SENHOR DO BONFIM;450;EPS;CORTE;2022-08-25;20;0;20;5;N
PORTO SEGURO;361;EPS;CORTE;2022-08-25;8;0;8;5;N
BOM JESUS DA LAPA;24;STC;CORTE;2022-08-16;11;11;0;3;N
LUIS EDUARDO MAGALHAES;323;STC;CORTE;2022-08-12;11;10;1;6;N
VITORIA DA CONQUISTA;503;EPS;CORTE;2022-08-02;15;15;0;3;N
SANTO ANTONIO DE JESUS;432;STC;CORTE;2022-08-02;26;25;1;3;N
ITAPETINGA;242;STC;CORTE;2022-08-02;9;9;0;3;N
ESPLANADA;84;EPS;CORTE;2022-08-23;6;6;0;3;N
BRUMADO;38;EPS;CORTE;2022-08-04;7;7;0;5;N
SANTO AMARO;424;STC;CORTE;2022-08-04;18;18;0;5;N
LUIS EDUARDO MAGALHAES;321;EPS;CORTE;2022-08-22;7;7;0;2;N
GRACA;131;EPS;CORTE;2022-08-15;21;20;1;2;N
PITUBA;357;EPS;CORTE;2022-08-15;20;19;1;2;N
SANTO ANTONIO DE JESUS;430;EPS;CORTE;2022-08-12;5;5;0;6;N
ILHEUS;175;STC;CORTE;2022-08-19;15;14;1;6;N
ITAPETINGA;245;STC;RECORTE;2022-08-16;13;8;5;3;N
FEIRA DE SANTANA SUL;124;EPS;RECORTE;2022-08-25;60;35;25;5;N
GUANAMBI;142;EPS;BAIXA;2022-08-10;2;2;0;4;N
SANTO AMARO;423;STC;CORTE;2022-08-16;9;9;0;3;N
FEIRA DE SANTANA NORTE;107;EPS;CORTE;2022-08-18;31;29;2;5;N
VITORIA DA CONQUISTA;504;STC;CORTE;2022-08-04;10;10;0;5;N
SANTO ANTONIO DE JESUS;9;STC;CORTE;2022-08-02;13;13;0;3;N
SANTO ANTONIO DE JESUS;8;STC;CORTE;2022-08-12;15;15;0;6;S
SANTO ANTONIO DE JESUS;433;EPS;RECORTE;2022-08-24;2;2;0;4;S
CAMACARI;52;EPS;CORTE;2022-08-12;22;21;1;6;N
SANTO AMARO;424;STC;CORTE;2022-08-02;9;9;0;3;S
ITABUNA;225;EPS;CORTE;2022-08-08;9;8;1;2;N
BOM JESUS DA LAPA;24;EPS;CORTE;2022-08-02;7;7;0;3;N
IRECE;207;STC;CORTE;2022-08-11;11;11;0;5;N
GUANAMBI;148;EPS;CORTE;2022-08-11;7;6;1;5;N
EUNAPOLIS;101;STC;CORTE;2022-08-09;11;10;1;3;N
TEIXEIRA DE FREITAS;481;EPS;CORTE;2022-08-03;8;8;0;4;N
ITAPETINGA;240;STC;CORTE;2022-08-24;18;18;0;4;S
FEIRA DE SANTANA SUL;121;STC;CORTE;2022-08-25;1;1;0;5;N
LAURO DE FREITAS;298;STC;CORTE;2022-08-25;30;30;0;5;S
RIBEIRA DO POMBAL;399;EPS;CORTE;2022-08-23;9;9;0;3;N
ITAPETINGA;239;EPS;CORTE;2022-08-24;11;11;0;4;N
JUAZEIRO;290;STC;CORTE;2022-08-23;2;2;0;3;N
AMARGOSA;11;EPS;DISJUNTOR;2022-08-23;1;1;0;3;N
PITUBA;359;STC;CORTE;2022-08-05;19;0;19;6;N
JACOBINA;261;EPS;CORTE;2022-08-05;9;0;9;6;N
ESPLANADA;79;EPS;BAIXA;2022-08-10;4;0;4;4;N
FEIRA DE SANTANA SUL;127;STC;RECORTE;2022-08-03;1;1;0;4;N
PIRAJA;353;EPS;DISJUNTOR;2022-08-25;32;0;32;5;N
PAULO AFONSO;332;EPS;CORTE;2022-08-25;8;0;8;5;N
VITORIA DA CONQUISTA;513;STC;CORTE;2022-08-19;11;11;0;6;N
LUIS EDUARDO MAGALHAES;318;STC;CORTE;2022-08-23;8;8;0;3;N
VITORIA DA CONQUISTA;499;STC;CORTE;2022-08-15;11;11;0;2;N
SENHOR DO BONFIM;450;EPS;CORTE;2022-08-02;16;15;1;3;N
PORTO SEGURO;370;EPS;DISJUNTOR;2022-08-23;4;4;0;3;N
LUIS EDUARDO MAGALHAES;319;STC;CORTE;2022-08-11;10;10;0;5;N
TEIXEIRA DE FREITAS;485;EPS;BAIXA;2022-08-05;17;17;0;6;N
CANDEIAS;59;EPS;CORTE;2022-08-23;21;20;1;3;N
REMANSO;391;EPS;CORTE;2022-08-23;43;42;1;3;N
ALAGOINHAS;1;STC;CORTE;2022-08-15;13;13;0;2;N
REMANSO;392;EPS;CORTE;2022-08-11;24;22;2;5;N
IRECE;202;STC;CORTE;2022-08-22;14;14;0;2;N
PERIPERI;349;EPS;CORTE;2022-08-15;14;14;0;2;N
CAMACARI;50;EPS;DISJUNTOR;2022-08-19;35;32;3;6;N
BOM JESUS DA LAPA;34;STC;CORTE;2022-08-19;16;16;0;6;N
IPIAU;531;STC;CORTE;2022-08-02;21;21;0;3;N
TEIXEIRA DE FREITAS;477;STC;CORTE;2022-08-16;17;17;0;3;N
PAULO AFONSO;325;EPS;RECORTE;2022-08-11;14;10;4;5;S
JACOBINA;260;EPS;RECORTE;2022-08-18;5;5;0;5;N
SERRINHA;464;EPS;BAIXA;2022-08-17;12;12;0;4;N
VALENCA;487;EPS;BAIXA;2022-08-18;15;11;4;5;N
SANTO ANTONIO DE JESUS;426;EPS;CORTE;2022-08-11;5;5;0;5;N
ESPLANADA;82;STC;CORTE;2022-08-12;11;11;0;6;N
BRUMADO;47;EPS;CORTE;2022-08-19;6;6;0;6;N
GRACA;132;STC;RECORTE;2022-08-18;17;14;3;5;N
PITUBA;359;STC;RECORTE;2022-08-04;7;0;7;5;S
SANTO ANTONIO DE JESUS;426;STC;CORTE;2022-08-25;13;13;0;5;N
LUIS EDUARDO MAGALHAES;318;EPS;CORTE;2022-08-09;7;7;0;3;N
JACOBINA;256;EPS;CORTE;2022-08-16;8;8;0;3;N
SANTO AMARO;424;STC;RECORTE;2022-08-05;13;0;13;6;N
VITORIA DA CONQUISTA;513;EPS;CORTE;2022-08-05;19;0;19;6;N
SERRINHA;463;EPS;CORTE;2022-08-05;8;0;8;6;N
JUAZEIRO;290;STC;RECORTE;2022-08-24;16;15;1;4;N
IBOTIRAMA;164;EPS;CORTE;2022-08-08;7;6;1;2;N
JUAZEIRO;288;EPS;CORTE;2022-08-10;15;14;1;4;N
SERRINHA;458;EPS;CORTE;2022-08-16;14;13;1;3;N
PIRAJA;353;EPS;DISJUNTOR;2022-08-02;16;15;1;3;N
SEABRA;436;STC;CORTE;2022-08-02;9;8;1;3;N
VITORIA DA CONQUISTA;523;STC;CORTE;2022-08-22;11;11;0;2;N
PERIPERI;347;STC;CORTE;2022-08-04;16;16;0;5;N
VITORIA DA CONQUISTA;509;STC;CORTE;2022-08-18;11;11;0;5;N
ITABERABA;220;STC;CORTE;2022-08-19;21;21;0;6;N
PAULO AFONSO;332;EPS;CORTE;2022-08-02;8;7;1;3;N
LIVRAMENTO DE NOSSA SENHORA;307;STC;CORTE;2022-08-18;6;6;0;5;N
SANTA MARIA DA VITORIA;417;STC;CORTE;2022-08-22;16;13;3;2;N
SENHOR DO BONFIM;450;EPS;RECORTE;2022-08-03;7;7;0;4;N
REMANSO;391;EPS;RECORTE;2022-08-24;32;32;0;4;N
ITAPETINGA;247;STC;CORTE;2022-08-16;9;9;0;3;N
ITABUNA;232;STC;CORTE;2022-08-12;16;15;1;6;N
POSTO DA MATA;385;EPS;CORTE;2022-08-04;18;17;1;5;N
REMANSO;389;STC;CORTE;2022-08-12;9;9;0;6;N
LIVRAMENTO DE NOSSA SENHORA;306;EPS;CORTE;2022-08-16;5;5;0;3;N
PAULO AFONSO;333;STC;CORTE;2022-08-04;10;10;0;5;N
ITABUNA;234;EPS;RECORTE;2022-08-24;11;10;1;4;N
SERRINHA;459;STC;CORTE;2022-08-18;11;11;0;5;N
GRACA;131;EPS;BAIXA;2022-08-16;5;5;0;3;N
SANTO AMARO;421;EPS;BAIXA;2022-08-25;15;15;0;5;S
FEIRA DE SANTANA SUL;121;STC;CORTE;2022-08-02;1;1;0;3;N
PERIPERI;347;EPS;DISJUNTOR;2022-08-22;52;51;1;2;N
JUAZEIRO;287;EPS;CORTE;2022-08-22;6;6;0;2;N
CONCEICAO DO COITE;72;EPS;CORTE;2022-08-08;10;10;0;2;N
SERRINHA;468;EPS;CORTE;2022-08-19;6;6;0;6;N
JUAZEIRO;284;EPS;CORTE;2022-08-09;15;14;1;3;N
ITABERABA;216;STC;CORTE;2022-08-18;41;40;1;5;N
ITABUNA;227;STC;CORTE;2022-08-23;16;16;0;3;N
ESPLANADA;78;EPS;CORTE;2022-08-23;14;12;2;3;N
GRACA;134;STC;CORTE;2022-08-18;34;33;1;5;N
SANTO ANTONIO DE JESUS;433;STC;CORTE;2022-08-15;19;18;1;2;N
VITORIA DA CONQUISTA;520;STC;CORTE;2022-08-09;11;11;0;3;N
LUIS EDUARDO MAGALHAES;323;EPS;CORTE;2022-08-23;8;7;1;3;N
FEIRA DE SANTANA NORTE;109;EPS;CORTE;2022-08-19;24;23;1;6;N
JACOBINA;264;STC;CORTE;2022-08-08;7;7;0;2;N
SANTA MARIA DA VITORIA;417;STC;RECORTE;2022-08-23;16;16;0;3;N
BARREIRAS;20;EPS;CORTE;2022-08-12;6;6;0;6;N
LAURO DE FREITAS;293;STC;CORTE;2022-08-15;16;15;1;2;N
IRECE;201;STC;CORTE;2022-08-11;11;11;0;5;N
JUAZEIRO;284;STC;CORTE;2022-08-23;9;9;0;3;N
CAMACARI;55;STC;CORTE;2022-08-15;16;15;1;2;N
ITABUNA;230;EPS;RECORTE;2022-08-23;25;24;1;3;N
VALENCA;492;EPS;CORTE;2022-08-08;20;20;0;2;N
IBOTIRAMA;161;STC;CORTE;2022-08-09;9;9;0;3;N
ITABUNA;234;EPS;BAIXA;2022-08-24;2;2;0;4;N
CANDEIAS;59;EPS;BAIXA;2022-08-24;16;16;0;4;N
RIBEIRA DO POMBAL;409;EPS;BAIXA;2022-08-25;20;19;1;5;S
BARREIRAS;22;STC;CORTE;2022-08-02;14;14;0;3;N
GUANAMBI;142;EPS;CORTE;2022-08-11;7;6;1;5;N
SENHOR DO BONFIM;446;STC;RECORTE;2022-08-16;11;11;0;3;N
SERRINHA;459;STC;RECORTE;2022-08-19;11;5;6;6;N
JEQUIE;266;STC;CORTE;2022-08-11;5;5;0;5;N
JUAZEIRO;285;STC;CORTE;2022-08-11;9;9;0;5;N
SERRINHA;456;STC;CORTE;2022-08-05;11;0;11;6;N
JEQUIE;278;EPS;CORTE;2022-08-25;13;0;13;5;N
FEIRA DE SANTANA SUL;127;STC;CORTE;2022-08-04;16;16;0;5;N
SEABRA;441;STC;CORTE;2022-08-16;11;11;0;3;N
RIBEIRA DO POMBAL;405;EPS;CORTE;2022-08-02;10;10;0;3;N
VALENCA;487;EPS;CORTE;2022-08-19;7;7;0;6;N
ITAPOAN;250;EPS;CORTE;2022-08-09;72;60;12;3;N
ITAPOAN;251;STC;CORTE;2022-08-11;19;19;0;5;N
IBOTIRAMA;171;STC;CORTE;2022-08-12;9;9;0;6;N
BRUMADO;43;STC;CORTE;2022-08-09;11;10;1;3;N
JACOBINA;258;EPS;CORTE;2022-08-17;8;8;0;4;N
PAULO AFONSO;338;EPS;CORTE;2022-08-04;5;5;0;5;N
JACOBINA;259;STC;CORTE;2022-08-19;15;15;0;6;N
EUNAPOLIS;91;STC;CORTE;2022-08-08;11;11;0;2;N
PORTO SEGURO;377;STC;CORTE;2022-08-19;10;10;0;6;S
LAURO DE FREITAS;293;STC;RECORTE;2022-08-16;32;27;5;3;N
IRECE;210;EPS;CORTE;2022-08-12;13;12;1;6;N
PORTO SEGURO;376;EPS;CORTE;2022-08-19;20;19;1;6;N
SENHOR DO BONFIM;451;EPS;CORTE;2022-08-15;6;6;0;2;N
PORTO SEGURO;366;EPS;RECORTE;2022-08-17;17;17;0;4;N
IRECE;211;EPS;BAIXA;2022-08-24;1;1;0;4;N
BOM JESUS DA LAPA;29;STC;CORTE;2022-08-05;5;5;0;6;S
CAMACARI;57;EPS;BAIXA;2022-08-25;2;2;0;5;S
BRUMADO;41;EPS;CORTE;2022-08-19;6;6;0;6;N
SEABRA;441;EPS;CORTE;2022-08-02;6;6;0;3;N
IBOTIRAMA;170;EPS;CORTE;2022-08-10;5;5;0;4;N
CONCEICAO DO COITE;72;STC;RECORTE;2022-08-23;11;9;2;3;N
BARREIRAS;16;STC;CORTE;2022-08-25;21;21;0;5;N
ILHEUS;179;EPS;CORTE;2022-08-08;16;16;0;2;N
FEIRA DE SANTANA SUL;126;STC;CORTE;2022-08-16;1;1;0;3;N
ESPLANADA;78;EPS;RECORTE;2022-08-24;8;7;1;4;N
VITORIA DA CONQUISTA;509;EPS;BAIXA;2022-08-05;17;0;17;6;N
SENHOR DO BONFIM;453;STC;CORTE;2022-08-05;13;0;13;6;N
BOM JESUS DA LAPA;28;EPS;CORTE;2022-08-05;6;0;6;6;N
LAURO DE FREITAS;298;EPS;CORTE;2022-08-15;16;16;0;2;N
SANTO AMARO;422;EPS;CORTE;2022-08-16;22;21;1;3;N
IRECE;205;EPS;CORTE;2022-08-23;20;19;1;3;N
IRECE;193;STC;CORTE;2022-08-09;33;32;1;3;N
FEIRA DE SANTANA NORTE;108;EPS;CORTE;2022-08-08;27;27;0;2;N
BRUMADO;39;STC;CORTE;2022-08-08;11;11;0;2;N
ALAGOINHAS;4;EPS;CORTE;2022-08-16;20;18;2;3;N
SANTO ANTONIO DE JESUS;8;STC;CORTE;2022-08-16;13;13;0;3;N
SANTO ANTONIO DE JESUS;431;EPS;CORTE;2022-08-02;6;6;0;3;N
CAMACARI;53;EPS;CORTE;2022-08-02;17;15;2;3;N
TEIXEIRA DE FREITAS;480;EPS;CORTE;2022-08-17;10;9;1;4;N
SANTO AMARO;423;STC;CORTE;2022-08-18;21;21;0;5;N
VITORIA DA CONQUISTA;525;STC;CORTE;2022-08-23;11;10;1;3;N
BOM JESUS DA LAPA;24;STC;CORTE;2022-08-18;16;16;0;5;N
SANTO ANTONIO DE JESUS;9;STC;CORTE;2022-08-04;13;13;0;5;N
IBOTIRAMA;167;STC;CORTE;2022-08-11;9;9;0;5;N
PIRAJA;353;STC;CORTE;2022-08-09;200;178;22;3;N
SANTO AMARO;423;STC;CORTE;2022-08-16;10;10;0;3;S
SANTA MARIA DA VITORIA;414;STC;DISJUNTOR;2022-08-16;25;25;0;3;S
PAULO AFONSO;403;EPS;RECORTE;2022-08-10;6;6;0;4;N
SANTO ANTONIO DE JESUS;8;EPS;CORTE;2022-08-02;6;6;0;3;N
ITAPOAN;250;EPS;RECORTE;2022-08-10;42;38;4;4;N
ITAPETINGA;241;STC;CORTE;2022-08-16;9;9;0;3;N
BOM JESUS DA LAPA;23;EPS;CORTE;2022-08-16;5;5;0;3;N
ITABUNA;226;STC;CORTE;2022-08-12;16;16;0;6;N
SEABRA;212;EPS;BAIXA;2022-08-04;7;7;0;5;N
ITABERABA;215;EPS;BAIXA;2022-08-17;3;3;0;4;N
SENHOR DO BONFIM;449;STC;CORTE;2022-08-04;9;8;1;5;N
BRUMADO;37;EPS;CORTE;2022-08-18;7;7;0;5;N
SEABRA;441;STC;RECORTE;2022-08-17;21;21;0;4;N
IBOTIRAMA;166;STC;CORTE;2022-08-23;6;6;0;3;N
PIRAJA;351;EPS;CORTE;2022-08-19;14;14;0;6;N
FEIRA DE SANTANA SUL;126;STC;RECORTE;2022-08-17;1;1;0;4;N
JUAZEIRO;289;EPS;CORTE;2022-08-23;15;15;0;3;N
BOM JESUS DA LAPA;29;STC;RECORTE;2022-08-08;11;10;1;2;N
ITAPETINGA;245;EPS;RECORTE;2022-08-04;9;9;0;5;N
PORTO SEGURO;372;EPS;CORTE;2022-08-18;10;10;0;5;N
FEIRA DE SANTANA SUL;122;STC;CORTE;2022-08-15;2;2;0;2;N
ITABERABA;214;EPS;CORTE;2022-08-05;6;0;6;6;N
GRACA;132;EPS;CORTE;2022-08-05;11;0;11;6;N
GUANAMBI;147;EPS;CORTE;2022-08-25;4;0;4;5;N
ESPLANADA;83;STC;CORTE;2022-08-02;11;10;1;3;N
SANTO AMARO;422;EPS;RECORTE;2022-08-17;21;18;3;4;N
TEIXEIRA DE FREITAS;476;EPS;CORTE;2022-08-16;10;10;0;3;N
IBOTIRAMA;155;STC;CORTE;2022-08-09;9;9;0;3;N
FEIRA DE SANTANA NORTE;109;STC;RECORTE;2022-08-11;117;116;1;5;N
SANTO ANTONIO DE JESUS;431;EPS;RECORTE;2022-08-03;8;8;0;4;N
ITABERABA;224;EPS;CORTE;2022-08-08;6;6;0;2;N
TEIXEIRA DE FREITAS;479;EPS;DISJUNTOR;2022-08-12;17;17;0;6;N
TEIXEIRA DE FREITAS;477;STC;CORTE;2022-08-18;21;21;0;5;N
ILHEUS;186;STC;CORTE;2022-08-12;16;16;0;6;N
BOM JESUS DA LAPA;23;EPS;RECORTE;2022-08-17;6;6;0;4;N
IRECE;203;STC;CORTE;2022-08-12;11;10;1;6;N
BRUMADO;49;STC;CORTE;2022-08-11;11;11;0;5;N
LUIS EDUARDO MAGALHAES;317;EPS;CORTE;2022-08-23;8;8;0;3;N
IRECE;205;EPS;RECORTE;2022-08-24;15;15;0;4;N
ITAPETINGA;245;EPS;BAIXA;2022-08-04;9;7;2;5;N
ITABUNA;185;EPS;BAIXA;2022-08-24;2;1;1;4;N
ITAPOAN;250;EPS;BAIXA;2022-08-10;21;11;10;4;N
JACOBINA;258;EPS;BAIXA;2022-08-18;3;3;0;5;N
ITABUNA;226;STC;RECORTE;2022-08-11;15;12;3;5;S
FEIRA DE SANTANA SUL;124;EPS;BAIXA;2022-08-25;1;1;0;5;S
FEIRA DE SANTANA SUL;122;STC;RECORTE;2022-08-16;16;10;6;3;N
LUIS EDUARDO MAGALHAES;318;EPS;CORTE;2022-08-11;7;7;0;5;N
ITABERABA;214;STC;RECORTE;2022-08-18;6;6;0;5;S
IRECE;207;STC;RECORTE;2022-08-12;15;10;5;6;S
VALENCA;498;STC;RECORTE;2022-08-23;16;9;7;3;S
LUIS EDUARDO MAGALHAES;318;STC;CORTE;2022-08-25;15;12;3;5;N
PAULO AFONSO;343;EPS;CORTE;2022-08-18;4;2;2;5;N
BOM JESUS DA LAPA;33;EPS;CORTE;2022-08-19;5;5;0;6;N
SANTO AMARO;421;EPS;DISJUNTOR;2022-08-11;6;6;0;5;N
ALAGOINHAS;4;EPS;RECORTE;2022-08-17;14;12;2;4;N
PORTO SEGURO;361;EPS;CORTE;2022-08-04;8;8;0;5;N
ALAGOINHAS;2;STC;CORTE;2022-08-05;25;0;25;6;N
VITORIA DA CONQUISTA;500;STC;CORTE;2022-08-05;11;0;11;6;N
VALENCA;497;EPS;DISJUNTOR;2022-08-05;11;0;11;6;N
LAURO DE FREITAS;296;EPS;CORTE;2022-08-16;16;16;0;3;N
PIRAJA;350;EPS;CORTE;2022-08-08;19;19;0;2;N
PAULO AFONSO;340;STC;CORTE;2022-08-19;16;15;1;6;N
VITORIA DA CONQUISTA;524;STC;CORTE;2022-08-12;11;11;0;6;N
CANDEIAS;58;STC;CORTE;2022-08-02;52;51;1;3;N
ITABUNA;231;EPS;CORTE;2022-08-12;17;16;1;6;N
BRUMADO;44;STC;CORTE;2022-08-22;11;11;0;2;N
ILHEUS;173;EPS;CORTE;2022-08-08;20;20;0;2;N
SANTO ANTONIO DE JESUS;427;STC;RECORTE;2022-08-16;17;16;1;3;N
LUIS EDUARDO MAGALHAES;317;EPS;RECORTE;2022-08-24;6;5;1;4;N
PAULO AFONSO;332;EPS;CORTE;2022-08-04;7;7;0;5;N
CONCEICAO DO COITE;75;EPS;CORTE;2022-08-23;7;7;0;3;N
ITAPETINGA;247;STC;CORTE;2022-08-18;9;9;0;5;N
FEIRA DE SANTANA NORTE;115;STC;CORTE;2022-08-12;16;16;0;6;N
BRUMADO;48;EPS;RECORTE;2022-08-10;4;3;1;4;N
ALAGOINHAS;4;EPS;BAIXA;2022-08-17;6;6;0;4;N
IRECE;205;EPS;BAIXA;2022-08-24;4;3;1;4;N
BOM JESUS DA LAPA;23;EPS;BAIXA;2022-08-17;5;5;0;4;N
GRACA;137;EPS;CORTE;2022-08-19;21;20;1;6;N
ITAPETINGA;239;EPS;BAIXA;2022-08-25;16;13;3;5;S
SANTA MARIA DA VITORIA;418;STC;CORTE;2022-08-12;11;11;0;6;N
SANTO ANTONIO DE JESUS;428;STC;RECORTE;2022-08-04;20;19;1;5;N
SENHOR DO BONFIM;445;EPS;CORTE;2022-08-15;6;6;0;2;N
JEQUIE;269;EPS;CORTE;2022-08-12;9;9;0;6;N
ALAGOINHAS;1;STC;RECORTE;2022-08-18;32;32;0;5;N
PITUBA;357;EPS;BAIXA;2022-08-18;9;7;2;5;N
LAURO DE FREITAS;298;EPS;BAIXA;2022-08-16;20;20;0;3;N
EUNAPOLIS;105;EPS;CORTE;2022-08-23;6;6;0;3;N
VALENCA;498;EPS;BAIXA;2022-08-11;1;1;0;5;N
VITORIA DA CONQUISTA;503;EPS;BAIXA;2022-08-05;1;1;0;6;N
SENHOR DO BONFIM;447;STC;CORTE;2022-08-05;8;0;8;6;N
IRECE;211;EPS;CORTE;2022-08-25;27;0;27;5;N
CAMACARI;55;EPS;CORTE;2022-08-03;13;13;0;4;N
SANTO ANTONIO DE JESUS;432;EPS;CORTE;2022-08-15;4;4;0;2;N
LAURO DE FREITAS;293;EPS;CORTE;2022-08-03;14;14;0;4;N
PAULO AFONSO;401;STC;CORTE;2022-08-23;11;11;0;3;N
RIBEIRA DO POMBAL;404;STC;CORTE;2022-08-04;11;11;0;5;N
GRACA;133;EPS;CORTE;2022-08-18;42;39;3;5;N
ITABERABA;215;EPS;CORTE;2022-08-18;3;3;0;5;N
JACOBINA;263;STC;CORTE;2022-08-22;14;14;0;2;N
PORTO SEGURO;366;EPS;CORTE;2022-08-18;9;8;1;5;N
CONCEICAO DO COITE;72;EPS;CORTE;2022-08-10;7;4;3;4;N
ITABUNA;230;STC;DISJUNTOR;2022-08-19;18;18;0;6;S
GRACA;135;STC;CORTE;2022-08-08;17;16;1;2;N
CONCEICAO DO COITE;73;STC;CORTE;2022-08-12;11;11;0;6;N
SEABRA;212;STC;CORTE;2022-08-19;11;11;0;6;N
JACOBINA;263;EPS;CORTE;2022-08-08;11;10;1;2;N
ITABUNA;233;STC;RECORTE;2022-08-03;16;13;3;4;N
JUAZEIRO;290;STC;RECORTE;2022-08-03;16;15;1;4;N
CANDEIAS;58;STC;RECORTE;2022-08-03;16;16;0;4;N
ITABUNA;227;STC;CORTE;2022-08-25;16;16;0;5;N
ILHEUS;183;EPS;CORTE;2022-08-11;22;22;0;5;N
FEIRA DE SANTANA NORTE;110;EPS;CORTE;2022-08-09;40;40;0;3;N
PIRAJA;351;STC;RECORTE;2022-08-09;5;1;4;3;S
LAURO DE FREITAS;294;STC;CORTE;2022-08-05;16;0;16;6;N
PAULO AFONSO;329;STC;CORTE;2022-08-05;11;0;11;6;N
CAMACARI;56;STC;CORTE;2022-08-05;7;0;7;6;N
SEABRA;212;EPS;CORTE;2022-08-05;6;0;6;6;N
ITABUNA;231;STC;RECORTE;2022-08-25;20;6;14;5;S
LUIS EDUARDO MAGALHAES;323;EPS;CORTE;2022-08-25;7;0;7;5;N
IPIAU;188;EPS;CORTE;2022-08-12;8;8;0;6;N
LAURO DE FREITAS;293;EPS;RECORTE;2022-08-04;20;16;4;5;N
JEQUIE;276;EPS;CORTE;2022-08-02;9;9;0;3;N
FEIRA DE SANTANA SUL;125;EPS;CORTE;2022-08-16;18;16;2;3;N
TEIXEIRA DE FREITAS;470;EPS;CORTE;2022-08-16;9;8;1;3;N
ILHEUS;180;STC;CORTE;2022-08-12;21;21;0;6;N
ESPLANADA;77;STC;CORTE;2022-08-02;11;9;2;3;N
FEIRA DE SANTANA NORTE;106;STC;CORTE;2022-08-22;25;25;0;2;N
IRECE;197;STC;CORTE;2022-08-12;11;11;0;6;N
PAULO AFONSO;325;STC;CORTE;2022-08-02;5;5;0;3;S
CAMACARI;52;STC;CORTE;2022-08-04;16;16;0;5;N
JEQUIE;277;STC;CORTE;2022-08-04;11;11;0;5;N
PAULO AFONSO;325;STC;CORTE;2022-08-04;15;12;3;5;N
JACOBINA;258;EPS;CORTE;2022-08-19;8;8;0;6;N
ITAPOAN;250;EPS;CORTE;2022-08-11;68;61;7;5;N
PAULO AFONSO;324;STC;CORTE;2022-08-16;11;11;0;3;N
ILHEUS;179;EPS;CORTE;2022-08-10;23;22;1;4;N
PORTO SEGURO;377;EPS;CORTE;2022-08-09;8;8;0;3;N
SEABRA;441;EPS;CORTE;2022-08-04;6;6;0;5;N
PIRAJA;355;EPS;CORTE;2022-08-22;13;13;0;2;N
SANTO ANTONIO DE JESUS;433;STC;RECORTE;2022-08-18;20;19;1;5;N
SEABRA;440;EPS;CORTE;2022-08-16;14;13;1;3;N
ILHEUS;178;EPS;CORTE;2022-08-22;22;21;1;2;N
GRACA;135;STC;RECORTE;2022-08-09;17;4;13;3;N
IRECE;199;EPS;RECORTE;2022-08-24;15;14;1;4;N
GUANAMBI;138;EPS;CORTE;2022-08-12;7;7;0;6;N
IRECE;195;EPS;CORTE;2022-08-22;6;6;0;2;N
CONCEICAO DO COITE;72;EPS;RECORTE;2022-08-11;5;5;0;5;N
FEIRA DE SANTANA NORTE;111;STC;RECORTE;2022-08-12;4;4;0;6;N
LAURO DE FREITAS;294;STC;RECORTE;2022-08-04;13;3;10;5;S
IBOTIRAMA;170;EPS;CORTE;2022-08-12;7;6;1;6;N
CONCEICAO DO COITE;71;EPS;DISJUNTOR;2022-08-05;6;0;6;6;N
SENHOR DO BONFIM;452;EPS;CORTE;2022-08-05;12;0;12;6;N
PORTO SEGURO;363;EPS;CORTE;2022-08-05;6;0;6;6;N
VITORIA DA CONQUISTA;519;STC;RECORTE;2022-08-24;11;11;0;4;N
FEIRA DE SANTANA NORTE;110;STC;RECORTE;2022-08-24;2;0;2;4;N
IRECE;207;STC;CORTE;2022-08-15;11;11;0;2;N
ITABUNA;225;EPS;CORTE;2022-08-12;15;14;1;6;N
EUNAPOLIS;89;EPS;DISJUNTOR;2022-08-03;6;6;0;4;N
SANTA MARIA DA VITORIA;417;STC;RECORTE;2022-08-02;11;10;1;3;N
FEIRA DE SANTANA SUL;121;EPS;CORTE;2022-08-15;17;17;0;2;N
PIRAJA;352;EPS;CORTE;2022-08-09;51;48;3;3;N
LAURO DE FREITAS;298;EPS;CORTE;2022-08-17;32;29;3;4;N
EUNAPOLIS;87;STC;CORTE;2022-08-09;21;21;0;3;N
RIBEIRA DO POMBAL;400;EPS;CORTE;2022-08-15;10;10;0;2;N
TEIXEIRA DE FREITAS;471;STC;RECORTE;2022-08-19;19;17;2;6;N
BRUMADO;38;STC;CORTE;2022-08-22;10;10;0;2;N
PERIPERI;348;STC;CORTE;2022-08-19;16;16;0;6;N
SANTO ANTONIO DE JESUS;8;EPS;CORTE;2022-08-04;6;6;0;5;N
PITUBA;359;STC;CORTE;2022-08-09;19;18;1;3;N
SANTA MARIA DA VITORIA;536;STC;CORTE;2022-08-19;16;16;0;6;N
PITUBA;357;EPS;CORTE;2022-08-19;18;17;1;6;N
SANTO ANTONIO DE JESUS;431;EPS;CORTE;2022-08-04;6;6;0;5;N
IRECE;211;EPS;RECORTE;2022-08-03;6;6;0;4;N
FEIRA DE SANTANA SUL;122;EPS;CORTE;2022-08-03;14;14;0;4;N
JUAZEIRO;291;STC;CORTE;2022-08-15;9;9;0;2;N
SANTO AMARO;424;STC;CORTE;2022-08-08;9;9;0;2;N
ILHEUS;176;STC;CORTE;2022-08-11;15;15;0;5;N
IRECE;193;STC;CORTE;2022-08-11;22;20;2;5;N
CAMACARI;55;EPS;BAIXA;2022-08-04;10;10;0;5;N
LUIS EDUARDO MAGALHAES;323;EPS;CORTE;2022-08-02;9;9;0;3;N
BRUMADO;38;EPS;CORTE;2022-08-08;7;7;0;2;N
PORTO SEGURO;373;EPS;CORTE;2022-08-08;11;11;0;2;N
IRECE;211;STC;RECORTE;2022-08-17;21;19;2;4;N
SANTO AMARO;422;EPS;CORTE;2022-08-18;20;19;1;5;N
PORTO SEGURO;377;EPS;RECORTE;2022-08-10;21;20;1;4;N
SANTA MARIA DA VITORIA;414;EPS;RECORTE;2022-08-24;5;3;2;4;N
ITABUNA;226;EPS;BAIXA;2022-08-24;1;1;0;4;N
VITORIA DA CONQUISTA;518;EPS;BAIXA;2022-08-22;12;5;7;2;N
EUNAPOLIS;88;EPS;DISJUNTOR;2022-08-15;5;4;1;2;N
ALAGOINHAS;4;EPS;CORTE;2022-08-18;19;17;2;5;N
EUNAPOLIS;85;EPS;CORTE;2022-08-19;8;8;0;6;N
IBOTIRAMA;157;STC;RECORTE;2022-08-11;8;8;0;5;N
POSTO DA MATA;386;EPS;CORTE;2022-08-19;7;7;0;6;N
BOM JESUS DA LAPA;23;EPS;CORTE;2022-08-18;10;9;1;5;N
GUANAMBI;148;EPS;CORTE;2022-08-15;5;5;0;2;N
BRUMADO;40;EPS;DISJUNTOR;2022-08-16;6;5;1;3;N
PAULO AFONSO;328;EPS;BAIXA;2022-08-04;17;15;2;5;N
JUAZEIRO;290;STC;CORTE;2022-08-25;8;8;0;5;S
ILHEUS;178;EPS;DISJUNTOR;2022-08-05;25;0;25;6;N
FEIRA DE SANTANA SUL;123;STC;CORTE;2022-08-05;1;0;1;6;N
PAULO AFONSO;334;EPS;CORTE;2022-08-05;6;0;6;6;N
PERIPERI;349;EPS;DISJUNTOR;2022-08-25;64;0;64;5;N
IRECE;205;EPS;CORTE;2022-08-25;42;0;42;5;N
IPIAU;530;EPS;CORTE;2022-08-04;11;11;0;5;N
LAURO DE FREITAS;298;EPS;RECORTE;2022-08-18;33;32;1;5;N
VALENCA;496;EPS;DISJUNTOR;2022-08-19;13;13;0;6;N
ITABUNA;185;EPS;CORTE;2022-08-02;19;19;0;3;N
ESPLANADA;83;STC;CORTE;2022-08-04;11;11;0;5;N
LUIS EDUARDO MAGALHAES;323;EPS;RECORTE;2022-08-03;7;7;0;4;N
LAURO DE FREITAS;295;STC;CORTE;2022-08-18;16;16;0;5;N
SANTO AMARO;419;STC;CORTE;2022-08-19;21;20;1;6;N
JACOBINA;257;EPS;CORTE;2022-08-08;11;11;0;2;N
VALENCA;493;EPS;CORTE;2022-08-23;11;11;0;3;N
CONCEICAO DO COITE;66;EPS;CORTE;2022-08-10;7;6;1;4;N
TEIXEIRA DE FREITAS;480;EPS;DISJUNTOR;2022-08-02;16;16;0;3;N
JUAZEIRO;285;EPS;CORTE;2022-08-24;16;15;1;4;N
CAMACARI;50;STC;CORTE;2022-08-03;13;12;1;4;S
FEIRA DE SANTANA SUL;125;EPS;BAIXA;2022-08-17;18;18;0;4;N
CONCEICAO DO COITE;65;EPS;CORTE;2022-08-22;6;6;0;2;N
VALENCA;497;EPS;RECORTE;2022-08-25;169;169;0;5;N
SANTO ANTONIO DE JESUS;426;EPS;CORTE;2022-08-15;4;4;0;2;N
ITAPETINGA;242;STC;RECORTE;2022-08-05;9;9;0;6;S
PORTO SEGURO;371;EPS;DISJUNTOR;2022-08-15;3;3;0;2;N
BRUMADO;48;EPS;CORTE;2022-08-11;6;5;1;5;N
SANTO ANTONIO DE JESUS;428;STC;CORTE;2022-08-05;19;0;19;6;N
ITAPETINGA;238;STC;CORTE;2022-08-05;9;0;9;6;N
ALAGOINHAS;1;EPS;CORTE;2022-08-05;36;0;36;6;N
SANTO AMARO;419;EPS;CORTE;2022-08-05;28;0;28;6;N
ALAGOINHAS;1;STC;CORTE;2022-08-19;2;2;0;6;N
VALENCA;494;EPS;CORTE;2022-08-11;7;7;0;5;N
LUIS EDUARDO MAGALHAES;317;EPS;CORTE;2022-08-25;7;0;7;5;N
BOM JESUS DA LAPA;30;EPS;CORTE;2022-08-08;6;6;0;2;N
EUNAPOLIS;92;STC;CORTE;2022-08-23;11;11;0;3;N
LIVRAMENTO DE NOSSA SENHORA;311;EPS;RECORTE;2022-08-10;5;4;1;4;N
ITABUNA;232;STC;CORTE;2022-08-16;16;16;0;3;N
ALAGOINHAS;2;STC;RECORTE;2022-08-08;9;9;0;2;N
ILHEUS;186;STC;RECORTE;2022-08-15;17;16;1;2;N
ESPLANADA;78;STC;CORTE;2022-08-15;22;22;0;2;N
PAULO AFONSO;407;STC;CORTE;2022-08-02;11;11;0;3;N
REMANSO;390;STC;CORTE;2022-08-04;17;17;0;5;N
SEABRA;443;STC;CORTE;2022-08-19;19;18;1;6;N
CANDEIAS;58;STC;CORTE;2022-08-04;26;25;1;5;N
CANDEIAS;58;STC;CORTE;2022-08-02;14;14;0;3;S
VITORIA DA CONQUISTA;525;STC;CORTE;2022-08-02;11;11;0;3;N
VALENCA;493;EPS;RECORTE;2022-08-24;26;24;2;4;N
REMANSO;389;STC;CORTE;2022-08-16;9;8;1;3;N
BRUMADO;47;EPS;RECORTE;2022-08-24;3;3;0;4;N
ITABUNA;233;STC;CORTE;2022-08-04;16;16;0;5;N
JEQUIE;271;STC;CORTE;2022-08-04;11;9;2;5;N
ITABUNA;185;EPS;RECORTE;2022-08-03;6;6;0;4;N
GRACA;129;STC;RECORTE;2022-08-09;17;7;10;3;N
ITAPETINGA;248;STC;CORTE;2022-08-08;9;8;1;2;N
SANTA MARIA DA VITORIA;411;EPS;BAIXA;2022-08-11;1;1;0;5;N
ITAPETINGA;240;EPS;BAIXA;2022-08-17;10;10;0;4;N
ITAPETINGA;241;EPS;BAIXA;2022-08-05;4;4;0;6;N
IRECE;192;EPS;BAIXA;2022-08-10;6;6;0;4;N
FEIRA DE SANTANA SUL;122;EPS;BAIXA;2022-08-04;7;3;4;5;N
RIBEIRA DO POMBAL;398;STC;RECORTE;2022-08-03;4;3;1;4;S
PORTO SEGURO;369;STC;RECORTE;2022-08-22;16;16;0;2;N
FEIRA DE SANTANA NORTE;113;EPS;CORTE;2022-08-24;4;4;0;4;N
ALAGOINHAS;1;STC;RECORTE;2022-08-18;25;16;9;5;S
IRECE;198;STC;CORTE;2022-08-25;19;18;1;5;N
SERRINHA;459;EPS;CORTE;2022-08-08;8;8;0;2;N
TEIXEIRA DE FREITAS;472;EPS;CORTE;2022-08-17;10;10;0;4;N
SANTO ANTONIO DE JESUS;431;EPS;BAIXA;2022-08-05;16;15;1;6;N
IPIAU;527;STC;CORTE;2022-08-05;13;0;13;6;N
PAULO AFONSO;341;STC;CORTE;2022-08-09;1;1;0;3;N
SENHOR DO BONFIM;446;EPS;CORTE;2022-08-05;14;0;14;6;N
ILHEUS;175;EPS;BAIXA;2022-08-10;2;0;2;4;N
JACOBINA;262;EPS;CORTE;2022-08-22;8;8;0;2;N
SANTO ANTONIO DE JESUS;433;STC;CORTE;2022-08-19;19;17;2;6;N
JACOBINA;264;STC;CORTE;2022-08-12;10;10;0;6;N
JEQUIE;270;EPS;RECORTE;2022-08-03;9;8;1;4;N
RIBEIRA DO POMBAL;406;EPS;RECORTE;2022-08-18;11;8;3;5;N
ITABUNA;232;EPS;RECORTE;2022-08-03;6;6;0;4;N
ITABUNA;228;STC;CORTE;2022-08-15;16;15;1;2;N
ITABERABA;216;STC;CORTE;2022-08-22;25;25;0;2;N
CONCEICAO DO COITE;74;STC;CORTE;2022-08-02;8;7;1;3;N
FEIRA DE SANTANA NORTE;109;EPS;CORTE;2022-08-23;32;28;4;3;N
VITORIA DA CONQUISTA;506;STC;CORTE;2022-08-09;11;11;0;3;N
LAURO DE FREITAS;294;STC;CORTE;2022-08-05;5;5;0;6;S
CAMACARI;55;STC;CORTE;2022-08-17;5;5;0;4;S
REMANSO;389;EPS;RECORTE;2022-08-03;16;15;1;4;N
JACOBINA;263;EPS;CORTE;2022-08-10;9;9;0;4;N
GRACA;134;EPS;CORTE;2022-08-08;14;13;1;2;N
FEIRA DE SANTANA NORTE;110;EPS;CORTE;2022-08-11;20;20;0;5;N
IBOTIRAMA;163;EPS;RECORTE;2022-08-25;8;8;0;5;N
BARREIRAS;20;EPS;CORTE;2022-08-16;7;7;0;3;N
LIVRAMENTO DE NOSSA SENHORA;302;EPS;CORTE;2022-08-19;5;4;1;6;N
JUAZEIRO;290;STC;RECORTE;2022-08-03;12;8;4;4;S
CONCEICAO DO COITE;72;EPS;CORTE;2022-08-12;7;7;0;6;N
PERIPERI;347;STC;RECORTE;2022-08-09;38;19;19;3;N
SENHOR DO BONFIM;447;STC;RECORTE;2022-08-08;17;17;0;2;N
ITAPOAN;253;STC;RECORTE;2022-08-15;19;15;4;2;N
VITORIA DA CONQUISTA;519;STC;CORTE;2022-08-25;11;10;1;5;N
PAULO AFONSO;401;STC;CORTE;2022-08-25;11;11;0;5;N
SANTA MARIA DA VITORIA;412;EPS;CORTE;2022-08-23;2;2;0;3;N
SERRINHA;456;STC;CORTE;2022-08-09;11;11;0;3;N
PAULO AFONSO;328;EPS;CORTE;2022-08-05;9;0;9;6;N
LAURO DE FREITAS;293;EPS;CORTE;2022-08-05;19;0;19;6;N
CAMACARI;55;EPS;CORTE;2022-08-05;19;0;19;6;N
JACOBINA;259;STC;CORTE;2022-08-23;13;13;0;3;N
ILHEUS;179;EPS;CORTE;2022-08-12;22;22;0;6;N
IRECE;211;EPS;CORTE;2022-08-04;13;13;0;5;N
BARREIRAS;20;EPS;RECORTE;2022-08-17;8;8;0;4;N
CAMACARI;50;EPS;CORTE;2022-08-16;21;21;0;3;N
BARREIRAS;16;EPS;CORTE;2022-08-15;35;34;1;2;N
CAMACARI;51;STC;CORTE;2022-08-18;16;14;2;5;N
LUIS EDUARDO MAGALHAES;322;STC;CORTE;2022-08-04;11;11;0;5;N
VALENCA;487;EPS;CORTE;2022-08-23;29;29;0;3;N
IRECE;196;EPS;CORTE;2022-08-12;13;13;0;6;N
FEIRA DE SANTANA NORTE;107;STC;CORTE;2022-08-12;16;16;0;6;N
CAMACARI;51;STC;CORTE;2022-08-16;15;15;0;3;S
ESPLANADA;77;STC;CORTE;2022-08-04;11;11;0;5;N
JACOBINA;263;EPS;RECORTE;2022-08-11;7;7;0;5;N
REMANSO;395;STC;CORTE;2022-08-18;11;11;0;5;N
IPIAU;532;STC;CORTE;2022-08-19;13;13;0;6;N
GRACA;129;EPS;CORTE;2022-08-19;21;21;0;6;N
IPIAU;189;EPS;CORTE;2022-08-02;11;11;0;3;N
JACOBINA;259;EPS;CORTE;2022-08-09;9;9;0;3;N
FEIRA DE SANTANA NORTE;109;EPS;RECORTE;2022-08-24;8;7;1;4;N
GUANAMBI;139;EPS;CORTE;2022-08-02;7;6;1;3;N
BRUMADO;44;EPS;BAIXA;2022-08-11;9;7;2;5;N
GRACA;137;EPS;BAIXA;2022-08-22;13;10;3;2;N
SEABRA;440;EPS;CORTE;2022-08-18;11;10;1;5;N
EUNAPOLIS;105;EPS;CORTE;2022-08-02;6;6;0;3;N
ILHEUS;180;EPS;BAIXA;2022-08-24;2;2;0;4;N
JEQUIE;275;EPS;CORTE;2022-08-16;21;20;1;3;N
IBOTIRAMA;171;EPS;CORTE;2022-08-02;3;3;0;3;N
IBOTIRAMA;156;EPS;CORTE;2022-08-10;5;5;0;4;N
JEQUIE;281;STC;RECORTE;2022-08-08;11;9;2;2;N
IBOTIRAMA;155;EPS;CORTE;2022-08-22;13;13;0;2;N
CONCEICAO DO COITE;68;STC;CORTE;2022-08-25;11;11;0;5;N
LIVRAMENTO DE NOSSA SENHORA;312;EPS;CORTE;2022-08-22;3;3;0;2;N
IPIAU;526;EPS;BAIXA;2022-08-04;6;1;5;5;N
SENHOR DO BONFIM;453;STC;CORTE;2022-08-09;13;13;0;3;N
BARREIRAS;18;STC;CORTE;2022-08-05;15;0;15;6;N
VITORIA DA CONQUISTA;508;EPS;BAIXA;2022-08-19;17;0;17;6;S
PIRAJA;351;EPS;CORTE;2022-08-23;13;12;1;3;N
FEIRA DE SANTANA SUL;122;STC;CORTE;2022-08-19;21;20;1;6;N
IBOTIRAMA;167;STC;CORTE;2022-08-15;9;9;0;2;N
PITUBA;358;EPS;CORTE;2022-08-09;20;18;2;3;N
ITABERABA;221;EPS;CORTE;2022-08-22;4;4;0;2;N
ITABUNA;236;STC;DISJUNTOR;2022-08-23;18;18;0;3;S
VALENCA;490;STC;RECORTE;2022-08-02;32;32;0;3;N
LAURO DE FREITAS;298;EPS;CORTE;2022-08-19;15;15;0;6;N
IRECE;192;EPS;CORTE;2022-08-11;13;13;0;5;N
LIVRAMENTO DE NOSSA SENHORA;310;STC;CORTE;2022-08-11;9;9;0;5;N
AMARGOSA;11;STC;CORTE;2022-08-11;18;18;0;5;N
PERIPERI;349;STC;CORTE;2022-08-09;32;29;3;3;N
IRECE;211;EPS;RECORTE;2022-08-05;10;10;0;6;N
VALENCA;487;EPS;RECORTE;2022-08-24;43;41;2;4;N
JEQUIE;275;EPS;RECORTE;2022-08-17;9;9;0;4;N
JUAZEIRO;290;EPS;CORTE;2022-08-15;30;29;1;2;N
PIRAJA;354;EPS;DISJUNTOR;2022-08-19;26;26;0;6;N
PIRAJA;352;EPS;CORTE;2022-08-11;16;15;1;5;N
EUNAPOLIS;86;STC;CORTE;2022-08-23;21;19;2;3;N
PERIPERI;347;EPS;CORTE;2022-08-19;22;18;4;6;N
FEIRA DE SANTANA SUL;121;EPS;CORTE;2022-08-17;18;17;1;4;N
EUNAPOLIS;88;EPS;DISJUNTOR;2022-08-17;4;4;0;4;N
PORTO SEGURO;376;EPS;RECORTE;2022-08-24;32;28;4;4;N
IPIAU;189;EPS;RECORTE;2022-08-03;8;7;1;4;N
ILHEUS;178;EPS;RECORTE;2022-08-25;17;17;0;5;N
FEIRA DE SANTANA NORTE;109;EPS;BAIXA;2022-08-24;4;4;0;4;N
ITAPETINGA;242;EPS;BAIXA;2022-08-18;5;3;2;5;N
JUAZEIRO;291;EPS;CORTE;2022-08-03;11;11;0;4;N
ITAPOAN;251;STC;RECORTE;2022-08-16;19;17;2;3;N
TEIXEIRA DE FREITAS;481;EPS;CORTE;2022-08-09;11;10;1;3;N
PIRAJA;352;STC;CORTE;2022-08-25;17;16;1;5;N
ILHEUS;174;EPS;CORTE;2022-08-23;9;9;0;3;N
PAULO AFONSO;335;STC;CORTE;2022-08-09;1;1;0;3;N
AMARGOSA;10;EPS;CORTE;2022-08-09;6;6;0;3;N
ESPLANADA;77;STC;RECORTE;2022-08-05;16;0;16;6;N
JUAZEIRO;292;STC;CORTE;2022-08-05;9;0;9;6;N
FEIRA DE SANTANA SUL;122;EPS;CORTE;2022-08-05;23;0;23;6;N
EUNAPOLIS;90;STC;RECORTE;2022-08-25;3;2;1;5;N
GRACA;133;EPS;BAIXA;2022-08-19;1;0;1;6;S
RIBEIRA DO POMBAL;400;EPS;RECORTE;2022-08-18;18;17;1;5;N
JUAZEIRO;291;EPS;RECORTE;2022-08-04;11;11;0;5;N
VALENCA;497;EPS;DISJUNTOR;2022-08-09;28;27;1;3;N
LUIS EDUARDO MAGALHAES;318;EPS;CORTE;2022-08-15;7;7;0;2;N
IRECE;203;STC;CORTE;2022-08-16;22;21;1;3;N
ESPLANADA;81;EPS;CORTE;2022-08-16;9;9;0;3;N
ESPLANADA;82;EPS;CORTE;2022-08-04;17;16;1;5;N
BRUMADO;35;STC;CORTE;2022-08-11;11;11;0;5;N
BARREIRAS;17;EPS;BAIXA;2022-08-04;8;8;0;5;N
JUAZEIRO;287;STC;CORTE;2022-08-16;9;9;0;3;N
ITABUNA;172;STC;CORTE;2022-08-02;16;16;0;3;N
CAMACARI;50;EPS;BAIXA;2022-08-17;20;16;4;4;N
PITUBA;358;EPS;RECORTE;2022-08-10;22;20;2;4;N
AMARGOSA;10;EPS;RECORTE;2022-08-10;5;4;1;4;N
JACOBINA;264;EPS;CORTE;2022-08-23;8;6;2;3;N
LAURO DE FREITAS;296;STC;CORTE;2022-08-08;16;16;0;2;N
ILHEUS;186;EPS;CORTE;2022-08-02;13;10;3;3;N
ILHEUS;187;STC;CORTE;2022-08-04;9;9;0;5;N
ITABUNA;226;EPS;RECORTE;2022-08-03;5;5;0;4;N
SENHOR DO BONFIM;449;STC;RECORTE;2022-08-09;11;9;2;3;N
SANTO ANTONIO DE JESUS;9;STC;RECORTE;2022-08-09;16;7;9;3;N
LIVRAMENTO DE NOSSA SENHORA;305;STC;CORTE;2022-08-22;6;6;0;2;N
VITORIA DA CONQUISTA;500;STC;CORTE;2022-08-09;11;11;0;3;N
PAULO AFONSO;345;STC;CORTE;2022-08-12;8;8;0;6;N
IBOTIRAMA;169;EPS;BAIXA;2022-08-25;12;11;1;5;S
ITABERABA;218;STC;CORTE;2022-08-23;7;4;3;3;N
ITABUNA;185;EPS;CORTE;2022-08-04;8;8;0;5;N
PIRAJA;353;STC;RECORTE;2022-08-12;100;27;73;6;S
LIVRAMENTO DE NOSSA SENHORA;309;STC;RECORTE;2022-08-24;13;12;1;4;N
LUIS EDUARDO MAGALHAES;323;EPS;RECORTE;2022-08-05;2;2;0;6;N
SANTA MARIA DA VITORIA;412;STC;RECORTE;2022-08-15;6;6;0;2;N
FEIRA DE SANTANA SUL;122;STC;RECORTE;2022-08-18;11;2;9;5;S
PAULO AFONSO;343;EPS;CORTE;2022-08-22;1;1;0;2;N
LAURO DE FREITAS;298;EPS;DISJUNTOR;2022-08-02;10;10;0;3;N
SANTO AMARO;421;EPS;DISJUNTOR;2022-08-15;3;3;0;2;N
PITUBA;359;STC;RECORTE;2022-08-12;21;7;14;6;N
VALENCA;493;EPS;CORTE;2022-08-25;11;0;11;5;N
FEIRA DE SANTANA NORTE;115;EPS;CORTE;2022-08-02;24;22;2;3;N
PORTO SEGURO;373;EPS;BAIXA;2022-08-11;13;11;2;5;N
ITAPETINGA;247;STC;CORTE;2022-08-22;9;9;0;2;N
REMANSO;389;EPS;CORTE;2022-08-04;9;9;0;5;N
BOM JESUS DA LAPA;31;STC;CORTE;2022-08-12;11;11;0;6;N
PAULO AFONSO;407;STC;CORTE;2022-08-04;11;11;0;5;N
ITABUNA;184;EPS;RECORTE;2022-08-17;24;24;0;4;N
ESPLANADA;77;EPS;CORTE;2022-08-15;14;14;0;2;N
VALENCA;495;STC;RECORTE;2022-08-16;34;33;1;3;N
BOM JESUS DA LAPA;33;EPS;RECORTE;2022-08-24;10;10;0;4;N
GUANAMBI;142;EPS;DISJUNTOR;2022-08-23;13;11;2;3;N
VITORIA DA CONQUISTA;510;STC;CORTE;2022-08-12;11;11;0;6;N
JACOBINA;257;EPS;RECORTE;2022-08-11;7;7;0;5;N
VITORIA DA CONQUISTA;508;EPS;CORTE;2022-08-22;14;14;0;2;N
FEIRA DE SANTANA SUL;127;EPS;CORTE;2022-08-19;18;18;0;6;N
ITAPOAN;253;STC;CORTE;2022-08-16;19;17;2;3;N
IRECE;207;EPS;BAIXA;2022-08-04;7;7;0;5;N
JUAZEIRO;290;EPS;BAIXA;2022-08-16;13;10;3;3;N
BRUMADO;46;STC;CORTE;2022-08-02;10;10;0;3;N
IRECE;203;STC;RECORTE;2022-08-17;21;19;2;4;N
SENHOR DO BONFIM;454;STC;CORTE;2022-08-22;13;13;0;2;N
ITABUNA;172;STC;RECORTE;2022-08-03;16;16;0;4;N
CANDEIAS;58;EPS;BAIXA;2022-08-16;13;12;1;3;N
AMARGOSA;10;EPS;BAIXA;2022-08-10;1;1;0;4;N
BOM JESUS DA LAPA;29;EPS;CORTE;2022-08-22;4;4;0;2;N
JUAZEIRO;287;STC;RECORTE;2022-08-17;5;1;4;4;N
IPIAU;526;EPS;CORTE;2022-08-05;11;0;11;6;N
SANTO AMARO;422;EPS;BAIXA;2022-08-19;16;0;16;6;S
ILHEUS;180;EPS;CORTE;2022-08-25;27;0;27;5;N
IRECE;197;EPS;CORTE;2022-08-25;45;0;45;5;N
FEIRA DE SANTANA NORTE;115;EPS;RECORTE;2022-08-03;36;35;1;4;N
VITORIA DA CONQUISTA;505;STC;CORTE;2022-08-23;11;11;0;3;N
PITUBA;359;EPS;CORTE;2022-08-22;15;15;0;2;N
BOM JESUS DA LAPA;27;STC;CORTE;2022-08-11;11;11;0;5;N
SANTO ANTONIO DE JESUS;434;STC;CORTE;2022-08-09;19;17;2;3;N
JUAZEIRO;285;EPS;CORTE;2022-08-03;11;11;0;4;N
PAULO AFONSO;402;STC;CORTE;2022-08-15;11;10;1;2;N
JACOBINA;263;EPS;CORTE;2022-08-12;9;9;0;6;N
ITABUNA;227;EPS;CORTE;2022-08-15;14;13;1;2;N
GRACA;133;EPS;CORTE;2022-08-22;21;21;0;2;N
RIBEIRA DO POMBAL;404;STC;CORTE;2022-08-08;12;12;0;2;N
BRUMADO;40;STC;CORTE;2022-08-23;10;10;0;3;S
FEIRA DE SANTANA NORTE;111;STC;CORTE;2022-08-15;20;20;0;2;N
ITABERABA;217;STC;CORTE;2022-08-12;22;22;0;6;N
IRECE;209;STC;CORTE;2022-08-18;19;18;1;5;N
LAURO DE FREITAS;296;EPS;RECORTE;2022-08-19;7;5;2;6;S
ITABERABA;215;EPS;CORTE;2022-08-22;4;4;0;2;N
TEIXEIRA DE FREITAS;473;STC;RECORTE;2022-08-22;19;16;3;2;N
PAULO AFONSO;340;STC;RECORTE;2022-08-22;10;8;2;2;S
SANTO ANTONIO DE JESUS;432;EPS;CORTE;2022-08-19;4;4;0;6;N
SERRINHA;459;EPS;RECORTE;2022-08-11;7;6;1;5;N
PORTO SEGURO;377;EPS;DISJUNTOR;2022-08-19;12;11;1;6;N
IRECE;201;EPS;BAIXA;2022-08-25;17;16;1;5;S
JUAZEIRO;285;EPS;BAIXA;2022-08-25;18;15;3;5;S
PERIPERI;347;STC;RECORTE;2022-08-09;9;2;7;3;S
SENHOR DO BONFIM;454;STC;RECORTE;2022-08-23;17;12;5;3;N
SANTO ANTONIO DE JESUS;9;EPS;CORTE;2022-08-19;8;7;1;6;N
SERRINHA;456;STC;CORTE;2022-08-11;11;11;0;5;N
BRUMADO;40;STC;CORTE;2022-08-25;11;11;0;5;N
SERRINHA;455;EPS;CORTE;2022-08-09;6;6;0;3;N
JEQUIE;277;STC;CORTE;2022-08-08;9;9;0;2;N
JUAZEIRO;285;EPS;RECORTE;2022-08-04;11;10;1;5;N
VITORIA DA CONQUISTA;518;EPS;DISJUNTOR;2022-08-08;29;28;1;2;N
TEIXEIRA DE FREITAS;479;STC;CORTE;2022-08-23;51;49;2;3;N
PAULO AFONSO;325;STC;CORTE;2022-08-08;12;11;1;2;N
VALENCA;498;EPS;DISJUNTOR;2022-08-22;21;21;0;2;N
PITUBA;356;STC;CORTE;2022-08-23;38;35;3;3;N
VITORIA DA CONQUISTA;503;EPS;DISJUNTOR;2022-08-16;23;23;0;3;N
VALENCA;493;EPS;RECORTE;2022-08-03;26;25;1;4;N
VITORIA DA CONQUISTA;515;EPS;CORTE;2022-08-12;15;14;1;6;N
SENHOR DO BONFIM;452;EPS;CORTE;2022-08-09;12;11;1;3;N
RIBEIRA DO POMBAL;399;STC;CORTE;2022-08-19;11;11;0;6;N
ITAPOAN;252;STC;CORTE;2022-08-03;10;10;0;4;S
LIVRAMENTO DE NOSSA SENHORA;303;EPS;RECORTE;2022-08-10;3;3;0;4;N
ITABERABA;215;EPS;RECORTE;2022-08-23;2;2;0;3;N
GUANAMBI;138;EPS;CORTE;2022-08-16;6;6;0;3;N
LUIS EDUARDO MAGALHAES;321;EPS;CORTE;2022-08-04;8;8;0;5;N
GRACA;130;EPS;CORTE;2022-08-09;63;62;1;3;N
EUNAPOLIS;92;STC;CORTE;2022-08-02;11;11;0;3;N
IPIAU;188;EPS;CORTE;2022-08-16;8;7;1;3;N
IBOTIRAMA;170;EPS;CORTE;2022-08-16;7;7;0;3;N
PORTO SEGURO;363;EPS;CORTE;2022-08-09;16;15;1;3;N
SANTO ANTONIO DE JESUS;428;EPS;CORTE;2022-08-18;8;8;0;5;N
LUIS EDUARDO MAGALHAES;320;EPS;CORTE;2022-08-16;7;7;0;3;N
JACOBINA;258;EPS;CORTE;2022-08-23;8;7;1;3;N
ITAPOAN;251;EPS;BAIXA;2022-08-25;15;13;2;5;S
GUANAMBI;139;EPS;CORTE;2022-08-04;7;7;0;5;N
VITORIA DA CONQUISTA;520;STC;RECORTE;2022-08-16;11;8;3;3;N
ITABERABA;213;STC;CORTE;2022-08-11;11;10;1;5;N
IBOTIRAMA;155;EPS;CORTE;2022-08-24;12;12;0;4;N
IPIAU;531;EPS;CORTE;2022-08-19;8;5;3;6;N
ALAGOINHAS;3;STC;CORTE;2022-08-22;2;2;0;2;N
ITABUNA;232;EPS;BAIXA;2022-08-05;1;0;1;6;N
VITORIA DA CONQUISTA;509;EPS;BAIXA;2022-08-11;17;0;17;5;N
JUAZEIRO;291;STC;CORTE;2022-08-19;9;8;1;6;N
POSTO DA MATA;387;EPS;CORTE;2022-08-11;14;12;2;5;N
PERIPERI;348;STC;CORTE;2022-08-23;27;27;0;3;N
IPIAU;188;EPS;RECORTE;2022-08-17;8;8;0;4;N
FEIRA DE SANTANA NORTE;116;EPS;CORTE;2022-08-15;42;42;0;2;N
SANTO ANTONIO DE JESUS;8;EPS;CORTE;2022-08-08;6;6;0;2;N
CANDEIAS;58;EPS;CORTE;2022-08-17;34;31;3;4;N
FEIRA DE SANTANA SUL;121;EPS;CORTE;2022-08-19;18;17;1;6;N
VALENCA;487;EPS;DISJUNTOR;2022-08-08;10;10;0;2;N
IRECE;193;STC;CORTE;2022-08-15;22;22;0;2;N
JUAZEIRO;290;EPS;CORTE;2022-08-17;30;30;0;4;N
VALENCA;486;STC;CORTE;2022-08-02;17;16;1;3;N
JACOBINA;255;EPS;CORTE;2022-08-10;9;9;0;4;N
VITORIA DA CONQUISTA;525;EPS;CORTE;2022-08-15;15;13;2;2;N
PERIPERI;348;EPS;CORTE;2022-08-09;32;32;0;3;N
EUNAPOLIS;86;EPS;CORTE;2022-08-11;1;1;0;5;N
REMANSO;391;STC;CORTE;2022-08-17;16;16;0;4;S
PORTO SEGURO;375;STC;CORTE;2022-08-02;15;14;1;3;N
BARREIRAS;13;EPS;CORTE;2022-08-04;8;8;0;5;N
CANDEIAS;59;STC;CORTE;2022-08-19;8;8;0;6;N
REMANSO;391;STC;CORTE;2022-08-19;19;19;0;6;N
PERIPERI;349;STC;CORTE;2022-08-11;16;15;1;5;N
ILHEUS;180;STC;RECORTE;2022-08-17;21;6;15;4;N
SENHOR DO BONFIM;452;EPS;RECORTE;2022-08-10;6;6;0;4;N
SANTA MARIA DA VITORIA;412;EPS;CORTE;2022-08-02;10;10;0;3;N
SENHOR DO BONFIM;448;EPS;CORTE;2022-08-08;8;7;1;2;N
LUIS EDUARDO MAGALHAES;320;EPS;RECORTE;2022-08-17;5;5;0;4;N
SERRINHA;464;EPS;RECORTE;2022-08-25;12;7;5;5;N
JACOBINA;261;STC;RECORTE;2022-08-02;32;32;0;3;N
BARREIRAS;13;STC;CORTE;2022-08-18;21;21;0;5;N
GRACA;134;EPS;BAIXA;2022-08-11;10;10;0;5;N
ITABUNA;234;STC;CORTE;2022-08-19;13;13;0;6;N
ILHEUS;178;EPS;DISJUNTOR;2022-08-09;15;14;1;3;N
IRECE;197;STC;RECORTE;2022-08-17;21;11;10;4;N
BARREIRAS;18;STC;RECORTE;2022-08-08;15;15;0;2;N
ILHEUS;180;EPS;RECORTE;2022-08-03;10;3;7;4;N
IRECE;197;EPS;RECORTE;2022-08-03;6;6;0;4;N
GUANAMBI;148;EPS;CORTE;2022-08-19;6;6;0;6;N
PIRAJA;353;STC;CORTE;2022-08-15;17;17;0;2;N
IBOTIRAMA;167;EPS;CORTE;2022-08-03;4;4;0;4;N
CONCEICAO DO COITE;64;STC;CORTE;2022-08-24;52;52;0;4;S
GRACA;131;STC;RECORTE;2022-08-12;17;11;6;6;N
CAMACARI;51;STC;RECORTE;2022-08-19;12;7;5;6;S
CAMACARI;52;STC;RECORTE;2022-08-09;13;7;6;3;N
BOM JESUS DA LAPA;32;STC;CORTE;2022-08-25;9;9;0;5;N
ITAPOAN;251;STC;RECORTE;2022-08-16;8;5;3;3;S
POSTO DA MATA;386;EPS;CORTE;2022-08-23;8;8;0;3;N
CONCEICAO DO COITE;63;EPS;CORTE;2022-08-24;4;4;0;4;N
FEIRA DE SANTANA SUL;123;STC;CORTE;2022-08-09;1;1;0;3;N
IBOTIRAMA;168;STC;CORTE;2022-08-05;9;0;9;6;N
PAULO AFONSO;334;EPS;CORTE;2022-08-09;7;6;1;3;N
JUAZEIRO;291;EPS;CORTE;2022-08-05;18;0;18;6;N
IRECE;207;EPS;CORTE;2022-08-05;13;0;13;6;N
PIRAJA;351;EPS;CORTE;2022-08-25;12;0;12;5;N
SERRINHA;456;EPS;CORTE;2022-08-22;7;7;0;2;N
IBOTIRAMA;163;STC;CORTE;2022-08-16;9;9;0;3;N
JUAZEIRO;286;EPS;CORTE;2022-08-16;15;13;2;3;N
PAULO AFONSO;330;STC;CORTE;2022-08-22;16;15;1;2;N
EUNAPOLIS;97;STC;CORTE;2022-08-16;21;19;2;3;N
ALAGOINHAS;1;EPS;CORTE;2022-08-09;27;27;0;3;N
IPIAU;188;EPS;BAIXA;2022-08-17;4;4;0;4;N
PAULO AFONSO;346;STC;CORTE;2022-08-02;11;11;0;3;N
SANTO ANTONIO DE JESUS;8;STC;DISJUNTOR;2022-08-03;20;20;0;4;S
AMARGOSA;5;EPS;CORTE;2022-08-22;10;9;1;2;N
SANTO ANTONIO DE JESUS;426;EPS;CORTE;2022-08-19;4;4;0;6;N
JUAZEIRO;287;STC;CORTE;2022-08-18;9;9;0;5;N
IRECE;203;STC;CORTE;2022-08-18;21;21;0;5;N
PORTO SEGURO;369;STC;CORTE;2022-08-23;10;10;0;3;S
JUAZEIRO;290;EPS;RECORTE;2022-08-18;40;40;0;5;N
VITORIA DA CONQUISTA;503;EPS;RECORTE;2022-08-11;15;15;0;5;N
IRECE;203;EPS;CORTE;2022-08-04;13;13;0;5;N
ESPLANADA;83;STC;CORTE;2022-08-08;11;10;1;2;N
FEIRA DE SANTANA NORTE;113;STC;CORTE;2022-08-16;1;1;0;3;N
ALAGOINHAS;2;STC;CORTE;2022-08-11;13;13;0;5;N
PORTO SEGURO;371;EPS;DISJUNTOR;2022-08-19;7;7;0;6;N
PORTO SEGURO;374;STC;RECORTE;2022-08-15;21;20;1;2;N
POSTO DA MATA;386;EPS;RECORTE;2022-08-24;5;5;0;4;N
EUNAPOLIS;98;STC;CORTE;2022-08-04;10;10;0;5;N
ILHEUS;178;EPS;BAIXA;2022-08-25;18;12;6;5;S
SANTA MARIA DA VITORIA;412;EPS;RECORTE;2022-08-03;3;3;0;4;N
PIRAJA;355;EPS;BAIXA;2022-08-25;32;24;8;5;S
LIVRAMENTO DE NOSSA SENHORA;311;STC;RECORTE;2022-08-02;7;7;0;3;N
IRECE;207;STC;RECORTE;2022-08-18;7;3;4;5;S
ITABERABA;217;EPS;CORTE;2022-08-23;7;7;0;3;N
VALENCA;494;EPS;CORTE;2022-08-15;7;7;0;2;N
PERIPERI;348;STC;RECORTE;2022-08-22;8;7;1;2;S
IBOTIRAMA;167;STC;RECORTE;2022-08-16;15;11;4;3;S
FEIRA DE SANTANA SUL;123;STC;RECORTE;2022-08-10;2;2;0;4;N
ITABERABA;218;STC;CORTE;2022-08-25;7;6;1;5;N
PORTO SEGURO;369;STC;CORTE;2022-08-25;11;11;0;5;N
JACOBINA;534;EPS;CORTE;2022-08-22;4;4;0;2;N
ILHEUS;186;EPS;CORTE;2022-08-04;11;0;11;5;N
SANTO AMARO;419;EPS;CORTE;2022-08-09;22;18;4;3;N
EUNAPOLIS;85;EPS;RECORTE;2022-08-24;3;2;1;4;N
SANTO AMARO;422;EPS;DISJUNTOR;2022-08-05;3;0;3;6;N
LUIS EDUARDO MAGALHAES;319;EPS;CORTE;2022-08-05;7;0;7;6;N
ITABERABA;222;STC;RECORTE;2022-08-25;4;4;0;5;S
GRACA;129;EPS;BAIXA;2022-08-22;2;0;2;2;N
VALENCA;491;STC;CORTE;2022-08-16;17;17;0;3;N
ITAPOAN;252;EPS;CORTE;2022-08-16;38;37;1;3;N
SENHOR DO BONFIM;453;EPS;CORTE;2022-08-22;5;5;0;2;N
IPIAU;527;STC;CORTE;2022-08-09;13;13;0;3;N
IRECE;203;STC;RECORTE;2022-08-17;10;7;3;4;S
BRUMADO;46;STC;CORTE;2022-08-04;5;4;1;5;N
ITAPETINGA;247;EPS;CORTE;2022-08-10;14;14;0;4;N
SERRINHA;468;STC;CORTE;2022-08-15;11;11;0;2;N
IRECE;198;EPS;CORTE;2022-08-15;13;13;0;2;N
BRUMADO;45;STC;CORTE;2022-08-16;11;10;1;3;N
FEIRA DE SANTANA NORTE;115;EPS;CORTE;2022-08-04;21;17;4;5;N
ALAGOINHAS;1;EPS;RECORTE;2022-08-10;64;63;1;4;N
SANTO AMARO;419;EPS;RECORTE;2022-08-10;14;12;2;4;N
BARREIRAS;20;STC;CORTE;2022-08-08;15;15;0;2;N
EUNAPOLIS;85;EPS;BAIXA;2022-08-24;1;1;0;4;N
ESPLANADA;78;STC;CORTE;2022-08-19;11;11;0;6;N
FEIRA DE SANTANA SUL;128;STC;CORTE;2022-08-23;2;2;0;3;N
LAURO DE FREITAS;293;EPS;DISJUNTOR;2022-08-15;17;17;0;2;N
ITAPOAN;253;EPS;CORTE;2022-08-04;23;22;1;5;N
SANTA MARIA DA VITORIA;417;EPS;CORTE;2022-08-16;7;7;0;3;N
FEIRA DE SANTANA SUL;128;EPS;CORTE;2022-08-09;19;19;0;3;N
PAULO AFONSO;340;EPS;CORTE;2022-08-11;8;8;0;5;N
SENHOR DO BONFIM;454;STC;CORTE;2022-08-22;11;10;1;2;S
ESPLANADA;78;EPS;CORTE;2022-08-05;17;0;17;6;N
ALAGOINHAS;1;STC;RECORTE;2022-08-24;50;45;5;4;N
CONCEICAO DO COITE;65;EPS;RECORTE;2022-08-25;2;2;0;5;S
GUANAMBI;142;EPS;DISJUNTOR;2022-08-25;21;0;21;5;N
SANTO AMARO;424;EPS;CORTE;2022-08-23;20;19;1;3;N
VITORIA DA CONQUISTA;519;EPS;CORTE;2022-08-15;15;15;0;2;N
IRECE;210;STC;CORTE;2022-08-08;11;11;0;2;N
VITORIA DA CONQUISTA;520;EPS;CORTE;2022-08-03;11;11;0;4;N
POSTO DA MATA;383;EPS;BAIXA;2022-08-11;10;9;1;5;N
SENHOR DO BONFIM;450;STC;CORTE;2022-08-23;13;13;0;3;N
SANTA MARIA DA VITORIA;414;STC;CORTE;2022-08-17;34;34;0;4;N
JACOBINA;264;EPS;CORTE;2022-08-02;7;6;1;3;N
FEIRA DE SANTANA SUL;124;STC;CORTE;2022-08-22;21;20;1;2;N
EUNAPOLIS;93;STC;RECORTE;2022-08-16;21;19;2;3;N
SANTA MARIA DA VITORIA;417;EPS;RECORTE;2022-08-17;4;4;0;4;N
GRACA;134;EPS;CORTE;2022-08-12;21;18;3;6;N
CONCEICAO DO COITE;72;EPS;CORTE;2022-08-16;7;7;0;3;N
VITORIA DA CONQUISTA;508;EPS;RECORTE;2022-08-25;16;9;7;5;N
CANDEIAS;58;STC;RECORTE;2022-08-09;32;14;18;3;N
ITABERABA;216;EPS;CORTE;2022-08-12;5;5;0;6;N
BRUMADO;49;EPS;BAIXA;2022-08-04;4;4;0;5;N
SEABRA;443;STC;RECORTE;2022-08-24;12;12;0;4;N
VITORIA DA CONQUISTA;520;EPS;BAIXA;2022-08-25;21;17;4;5;S
ILHEUS;186;EPS;BAIXA;2022-08-05;19;2;17;6;N
ITAPOAN;254;STC;RECORTE;2022-08-05;9;7;2;6;S
SANTA MARIA DA VITORIA;413;EPS;CORTE;2022-08-15;7;7;0;2;N
EUNAPOLIS;102;EPS;CORTE;2022-08-16;7;7;0;3;N
SANTO ANTONIO DE JESUS;433;EPS;CORTE;2022-08-09;5;4;1;3;N
PAULO AFONSO;403;STC;CORTE;2022-08-05;11;0;11;6;N
SANTA MARIA DA VITORIA;415;STC;CORTE;2022-08-05;7;0;7;6;N
FEIRA DE SANTANA SUL;128;STC;RECORTE;2022-08-24;1;1;0;4;N
VITORIA DA CONQUISTA;500;EPS;CORTE;2022-08-22;13;13;0;2;N
GRACA;129;EPS;CORTE;2022-08-23;22;21;1;3;N
TEIXEIRA DE FREITAS;482;EPS;RECORTE;2022-08-25;38;21;17;5;N
ITABUNA;172;EPS;CORTE;2022-08-15;14;13;1;2;N
ALAGOINHAS;2;EPS;CORTE;2022-08-22;26;26;0;2;N
VITORIA DA CONQUISTA;520;EPS;RECORTE;2022-08-04;16;12;4;5;N
FEIRA DE SANTANA NORTE;107;EPS;CORTE;2022-08-02;43;39;4;3;N
SANTO AMARO;422;STC;CORTE;2022-08-12;9;9;0;6;N
CONCEICAO DO COITE;68;EPS;CORTE;2022-08-15;7;7;0;2;N
IPIAU;188;EPS;CORTE;2022-08-18;8;8;0;5;N
GRACA;130;EPS;CORTE;2022-08-11;21;21;0;5;N
IRECE;197;EPS;CORTE;2022-08-04;13;13;0;5;N
BOM JESUS DA LAPA;23;STC;CORTE;2022-08-12;11;11;0;6;N
ITAPETINGA;239;STC;CORTE;2022-08-22;9;8;1;2;N
LUIS EDUARDO MAGALHAES;320;EPS;CORTE;2022-08-18;7;5;2;5;N
SENHOR DO BONFIM;454;EPS;BAIXA;2022-08-11;20;18;2;5;N
FEIRA DE SANTANA NORTE;108;STC;CORTE;2022-08-04;21;21;0;5;N
SERRINHA;466;EPS;CORTE;2022-08-02;4;4;0;3;N
SANTO AMARO;424;EPS;RECORTE;2022-08-24;21;21;0;4;N
SANTO AMARO;423;EPS;DISJUNTOR;2022-08-18;4;4;0;5;N
TEIXEIRA DE FREITAS;472;EPS;BAIXA;2022-08-22;9;9;0;2;N
PORTO SEGURO;365;EPS;BAIXA;2022-08-11;1;1;0;5;N
IPIAU;532;EPS;CORTE;2022-08-09;8;8;0;3;N
TEIXEIRA DE FREITAS;469;STC;RECORTE;2022-08-23;17;17;0;3;N
IBOTIRAMA;161;EPS;RECORTE;2022-08-04;6;6;0;5;N
PITUBA;358;EPS;DISJUNTOR;2022-08-19;17;17;0;6;N
PITUBA;359;EPS;RECORTE;2022-08-25;138;138;0;5;N
BARREIRAS;18;STC;CORTE;2022-08-09;15;15;0;3;N
ITABUNA;227;STC;DISJUNTOR;2022-08-12;22;22;0;6;S
PITUBA;356;STC;CORTE;2022-08-25;38;37;1;5;N
GRACA;130;STC;CORTE;2022-08-25;20;20;0;5;N
ITABUNA;228;STC;RECORTE;2022-08-18;5;4;1;5;S
ILHEUS;180;EPS;CORTE;2022-08-04;12;0;12;5;N
IBOTIRAMA;157;EPS;CORTE;2022-08-02;3;3;0;3;N
ITABERABA;216;STC;RECORTE;2022-08-25;2;1;1;5;S
PAULO AFONSO;345;EPS;CORTE;2022-08-25;8;0;8;5;N
CANDEIAS;58;EPS;CORTE;2022-08-19;44;39;5;6;N
PIRAJA;352;EPS;CORTE;2022-08-15;48;47;1;2;N
JUAZEIRO;290;EPS;CORTE;2022-08-19;30;30;0;6;N
LIVRAMENTO DE NOSSA SENHORA;310;STC;CORTE;2022-08-15;9;9;0;2;N
PERIPERI;348;EPS;CORTE;2022-08-11;30;28;2;5;N
RIBEIRA DO POMBAL;410;STC;CORTE;2022-08-12;11;11;0;6;N
ILHEUS;179;EPS;RECORTE;2022-08-17;9;9;0;4;N
SENHOR DO BONFIM;454;STC;RECORTE;2022-08-02;17;16;1;3;N
FEIRA DE SANTANA NORTE;116;EPS;CORTE;2022-08-17;45;43;2;4;N
PIRAJA;355;EPS;DISJUNTOR;2022-08-11;18;18;0;5;N
JUAZEIRO;292;STC;CORTE;2022-08-09;9;9;0;3;N
CAMACARI;50;EPS;DISJUNTOR;2022-08-03;16;16;0;4;N
LUIS EDUARDO MAGALHAES;317;STC;CORTE;2022-08-19;21;20;1;6;N
RIBEIRA DO POMBAL;409;EPS;CORTE;2022-08-10;11;11;0;4;N
SENHOR DO BONFIM;448;STC;CORTE;2022-08-22;15;15;0;2;S
IPIAU;532;EPS;RECORTE;2022-08-10;8;6;2;4;N
IBOTIRAMA;166;EPS;CORTE;2022-08-17;7;6;1;4;N
RIBEIRA DO POMBAL;408;EPS;CORTE;2022-08-22;9;9;0;2;N
ITAPETINGA;248;EPS;CORTE;2022-08-23;11;11;0;3;N
FEIRA DE SANTANA NORTE;107;STC;RECORTE;2022-08-17;20;13;7;4;N
LAURO DE FREITAS;298;EPS;CORTE;2022-08-23;14;12;2;3;N
IRECE;192;EPS;CORTE;2022-08-15;11;11;0;2;N
SANTA MARIA DA VITORIA;536;EPS;CORTE;2022-08-11;8;8;0;5;N
CONCEICAO DO COITE;65;STC;CORTE;2022-08-16;11;10;1;3;N
IBOTIRAMA;161;EPS;BAIXA;2022-08-04;7;6;1;5;N
ITABERABA;223;EPS;CORTE;2022-08-02;5;5;0;3;N
JACOBINA;260;STC;RECORTE;2022-08-16;11;10;1;3;N
PERIPERI;348;STC;CORTE;2022-08-25;16;15;1;5;N
PERIPERI;347;EPS;CORTE;2022-08-23;22;22;0;3;N
JACOBINA;255;EPS;CORTE;2022-08-12;9;9;0;6;N
FEIRA DE SANTANA SUL;122;EPS;CORTE;2022-08-09;19;19;0;3;N
JEQUIE;273;STC;CORTE;2022-08-09;11;11;0;3;N
SEABRA;437;EPS;CORTE;2022-08-09;5;5;0;3;N
REMANSO;391;STC;CORTE;2022-08-19;8;8;0;6;S
PIRAJA;354;STC;CORTE;2022-08-05;17;0;17;6;N
ILHEUS;173;STC;CORTE;2022-08-04;19;19;0;5;N
FEIRA DE SANTANA NORTE;112;EPS;CORTE;2022-08-16;26;22;4;3;N
VITORIA DA CONQUISTA;522;STC;CORTE;2022-08-18;11;11;0;5;N
LIVRAMENTO DE NOSSA SENHORA;306;STC;CORTE;2022-08-12;11;11;0;6;S
PITUBA;356;STC;CORTE;2022-08-02;57;57;0;3;N
TEIXEIRA DE FREITAS;479;STC;CORTE;2022-08-02;17;16;1;3;N
PAULO AFONSO;336;STC;RECORTE;2022-08-02;11;10;1;3;N
PIRAJA;350;STC;CORTE;2022-08-04;17;16;1;5;N
PAULO AFONSO;345;EPS;CORTE;2022-08-02;8;6;2;3;N
IPIAU;532;EPS;BAIXA;2022-08-10;5;5;0;4;N
PAULO AFONSO;346;STC;CORTE;2022-08-04;11;11;0;5;N
VITORIA DA CONQUISTA;521;EPS;CORTE;2022-08-16;15;14;1;3;N
ITAPETINGA;237;EPS;CORTE;2022-08-09;11;11;0;3;N
ALAGOINHAS;1;EPS;CORTE;2022-08-11;30;28;2;5;N
AMARGOSA;11;STC;RECORTE;2022-08-16;18;17;1;3;N
PAULO AFONSO;333;EPS;RECORTE;2022-08-24;2;2;0;4;N
LAURO DE FREITAS;294;EPS;CORTE;2022-08-22;15;14;1;2;N
LAURO DE FREITAS;295;EPS;CORTE;2022-08-10;17;17;0;4;N
GRACA;137;STC;CORTE;2022-08-15;17;16;1;2;N
SANTO AMARO;419;EPS;CORTE;2022-08-11;22;20;2;5;N
ILHEUS;187;STC;CORTE;2022-08-08;6;6;0;2;N
LIVRAMENTO DE NOSSA SENHORA;312;EPS;BAIXA;2022-08-25;9;9;0;5;S
VITORIA DA CONQUISTA;500;EPS;BAIXA;2022-08-23;19;19;0;3;N
IBOTIRAMA;163;STC;CORTE;2022-08-18;16;16;0;5;N
CAMACARI;56;EPS;CORTE;2022-08-22;18;18;0;2;N
SERRINHA;456;EPS;CORTE;2022-08-24;6;5;1;4;N
SERRINHA;459;STC;CORTE;2022-08-02;11;11;0;3;N
PERIPERI;348;STC;RECORTE;2022-08-24;20;7;13;4;S
IBOTIRAMA;155;EPS;BAIXA;2022-08-25;10;10;0;5;S
CANDEIAS;59;STC;RECORTE;2022-08-22;8;4;4;2;N
SERRINHA;457;EPS;CORTE;2022-08-12;8;8;0;6;N
PIRAJA;353;STC;RECORTE;2022-08-16;51;42;9;3;S
FEIRA DE SANTANA NORTE;113;STC;CORTE;2022-08-18;2;2;0;5;N
JACOBINA;534;EPS;CORTE;2022-08-24;8;8;0;4;N
IBOTIRAMA;162;EPS;CORTE;2022-08-16;6;6;0;3;N
VALENCA;495;EPS;CORTE;2022-08-05;24;0;24;6;N
FEIRA DE SANTANA SUL;122;STC;RECORTE;2022-08-24;21;19;2;4;N
CAMACARI;50;EPS;BAIXA;2022-08-19;19;0;19;6;S
ITABERABA;217;EPS;CORTE;2022-08-25;3;0;3;5;N
BRUMADO;44;EPS;CORTE;2022-08-16;7;7;0;3;N
PAULO AFONSO;341;STC;CORTE;2022-08-15;11;11;0;2;N
BRUMADO;45;EPS;CORTE;2022-08-04;7;7;0;5;N
PITUBA;356;STC;RECORTE;2022-08-03;34;32;2;4;N
PIRAJA;353;EPS;BAIXA;2022-08-04;20;18;2;5;N
ESPLANADA;77;EPS;CORTE;2022-08-19;12;11;1;6;N
VALENCA;493;EPS;DISJUNTOR;2022-08-12;16;14;2;6;N
VALENCA;490;EPS;CORTE;2022-08-16;14;14;0;3;N
ESPLANADA;79;STC;CORTE;2022-08-09;26;26;0;3;N
ITAPOAN;254;STC;CORTE;2022-08-08;19;18;1;2;N
ESPLANADA;82;STC;RECORTE;2022-08-23;21;18;3;3;N
SERRINHA;456;EPS;RECORTE;2022-08-25;6;5;1;5;N
FEIRA DE SANTANA SUL;127;EPS;CORTE;2022-08-23;16;16;0;3;N
VALENCA;491;EPS;CORTE;2022-08-04;16;16;0;5;N
VALENCA;491;STC;CORTE;2022-08-18;17;11;6;5;N
JEQUIE;279;STC;CORTE;2022-08-11;9;9;0;5;N
SANTO ANTONIO DE JESUS;427;EPS;RECORTE;2022-08-10;6;6;0;4;N
JACOBINA;262;STC;CORTE;2022-08-16;16;16;0;3;N
JACOBINA;534;EPS;RECORTE;2022-08-25;8;4;4;5;N
IRECE;193;EPS;BAIXA;2022-08-04;21;20;1;5;N
SENHOR DO BONFIM;454;EPS;CORTE;2022-08-12;6;6;0;6;N
LAURO DE FREITAS;295;EPS;RECORTE;2022-08-11;13;11;2;5;N
CONCEICAO DO COITE;63;EPS;CORTE;2022-08-03;3;3;0;4;N
PAULO AFONSO;345;EPS;RECORTE;2022-08-03;5;5;0;4;N
TEIXEIRA DE FREITAS;479;STC;RECORTE;2022-08-03;17;15;2;4;N
AMARGOSA;5;EPS;RECORTE;2022-08-25;39;39;0;5;N
LAURO DE FREITAS;295;STC;RECORTE;2022-08-23;11;6;5;3;S
CONCEICAO DO COITE;64;STC;CORTE;2022-08-03;4;4;0;4;S
FEIRA DE SANTANA SUL;128;STC;CORTE;2022-08-25;1;1;0;5;N
CAMACARI;55;EPS;DISJUNTOR;2022-08-17;7;7;0;4;N
IPIAU;526;EPS;CORTE;2022-08-09;8;8;0;3;N
GUANAMBI;142;STC;CORTE;2022-08-09;11;11;0;3;N
PIRAJA;350;STC;RECORTE;2022-08-05;17;0;17;6;N
ILHEUS;180;EPS;DISJUNTOR;2022-08-12;32;31;1;6;N
SANTO ANTONIO DE JESUS;9;EPS;CORTE;2022-08-23;8;8;0;3;N
PORTO SEGURO;375;EPS;CORTE;2022-08-15;18;18;0;2;N
ILHEUS;183;STC;RECORTE;2022-08-08;17;12;5;2;N
ITAPOAN;252;EPS;RECORTE;2022-08-19;100;73;27;6;N
EUNAPOLIS;97;EPS;BAIXA;2022-08-05;13;13;0;6;N
FEIRA DE SANTANA SUL;123;EPS;CORTE;2022-08-22;54;53;1;2;N
GRACA;135;EPS;CORTE;2022-08-02;25;25;0;3;N
ITABERABA;217;EPS;CORTE;2022-08-02;5;5;0;3;N
ILHEUS;178;STC;CORTE;2022-08-18;21;20;1;5;N
VALENCA;491;STC;RECORTE;2022-08-19;17;16;1;6;N
PAULO AFONSO;342;STC;RECORTE;2022-08-02;3;2;1;3;S
RIBEIRA DO POMBAL;404;STC;CORTE;2022-08-12;11;11;0;6;N
ITAPOAN;250;STC;CORTE;2022-08-05;6;6;0;6;S
BRUMADO;44;EPS;RECORTE;2022-08-17;4;4;0;4;N
ITABUNA;227;EPS;CORTE;2022-08-19;14;13;1;6;N
FEIRA DE SANTANA SUL;124;EPS;CORTE;2022-08-10;18;18;0;4;N
SANTO ANTONIO DE JESUS;432;EPS;CORTE;2022-08-23;4;4;0;3;N
SEABRA;442;EPS;RECORTE;2022-08-24;4;4;0;4;N
ITAPOAN;254;STC;RECORTE;2022-08-09;19;6;13;3;N
VALENCA;490;EPS;RECORTE;2022-08-17;8;7;1;4;N
FEIRA DE SANTANA NORTE;110;EPS;CORTE;2022-08-17;45;44;1;4;N
FEIRA DE SANTANA NORTE;112;EPS;BAIXA;2022-08-17;7;6;1;4;N
VALENCA;494;EPS;BAIXA;2022-08-18;15;15;0;5;N
FEIRA DE SANTANA SUL;125;STC;CORTE;2022-08-12;1;1;0;6;N
GUANAMBI;152;STC;CORTE;2022-08-12;16;15;1;6;N
CANDEIAS;58;STC;RECORTE;2022-08-09;4;2;2;3;S
IPIAU;526;EPS;RECORTE;2022-08-10;8;8;0;4;N
SENHOR DO BONFIM;450;STC;CORTE;2022-08-25;13;13;0;5;N
IRECE;200;STC;RECORTE;2022-08-08;16;16;0;2;N
FEIRA DE SANTANA NORTE;111;EPS;CORTE;2022-08-05;25;0;25;6;N
SANTO AMARO;424;EPS;CORTE;2022-08-25;28;0;28;5;N
CAMACARI;50;EPS;CORTE;2022-08-22;14;14;0;2;N
PORTO SEGURO;373;EPS;DISJUNTOR;2022-08-22;19;18;1;2;N
FEIRA DE SANTANA NORTE;106;EPS;CORTE;2022-08-16;64;62;2;3;N
CAMACARI;51;EPS;CORTE;2022-08-10;38;36;2;4;N
ITAPETINGA;245;STC;RECORTE;2022-08-02;13;7;6;3;N
LUIS EDUARDO MAGALHAES;321;EPS;CORTE;2022-08-08;10;8;2;2;N
SANTO AMARO;422;STC;CORTE;2022-08-12;44;43;1;6;S
CONCEICAO DO COITE;69;STC;CORTE;2022-08-17;13;13;0;4;S
SANTO AMARO;423;STC;CORTE;2022-08-02;9;8;1;3;N
JACOBINA;259;EPS;CORTE;2022-08-15;9;9;0;2;N
FEIRA DE SANTANA NORTE;107;STC;CORTE;2022-08-18;12;12;0;5;N
VITORIA DA CONQUISTA;506;STC;RECORTE;2022-08-16;11;9;2;3;N
ITABERABA;217;EPS;RECORTE;2022-08-03;10;10;0;4;N
POSTO DA MATA;383;STC;RECORTE;2022-08-02;10;9;1;3;S
PITUBA;357;STC;CORTE;2022-08-15;19;18;1;2;N
RIBEIRA DO POMBAL;400;STC;CORTE;2022-08-11;11;11;0;5;N
IPIAU;532;EPS;CORTE;2022-08-11;8;8;0;5;N
RIBEIRA DO POMBAL;399;STC;CORTE;2022-08-23;11;11;0;3;N
ITAPETINGA;239;EPS;CORTE;2022-08-10;14;14;0;4;N
VITORIA DA CONQUISTA;519;EPS;RECORTE;2022-08-18;16;16;0;5;N
IPIAU;526;EPS;BAIXA;2022-08-10;5;4;1;4;N
IBOTIRAMA;156;EPS;CORTE;2022-08-16;6;6;0;3;N
GRACA;135;EPS;RECORTE;2022-08-03;38;38;0;4;N
SANTO ANTONIO DE JESUS;432;EPS;RECORTE;2022-08-24;8;7;1;4;N
SANTO ANTONIO DE JESUS;9;EPS;RECORTE;2022-08-24;8;8;0;4;N
JACOBINA;260;EPS;CORTE;2022-08-03;3;3;0;4;N
BRUMADO;44;EPS;BAIXA;2022-08-17;4;4;0;4;N
VALENCA;491;EPS;BAIXA;2022-08-05;18;18;0;6;N
SANTO ANTONIO DE JESUS;428;EPS;CORTE;2022-08-22;8;8;0;2;N
ALAGOINHAS;3;EPS;CORTE;2022-08-12;10;9;1;6;N
ITABERABA;213;STC;CORTE;2022-08-15;11;10;1;2;N
GRACA;136;STC;RECORTE;2022-08-03;11;7;4;4;S
JACOBINA;260;EPS;BAIXA;2022-08-25;14;14;0;5;S
CONCEICAO DO COITE;68;EPS;CORTE;2022-08-17;7;6;1;4;N
RIBEIRA DO POMBAL;404;STC;RECORTE;2022-08-11;5;4;1;5;S
RIBEIRA DO POMBAL;399;EPS;CORTE;2022-08-09;11;10;1;3;N
PAULO AFONSO;332;STC;CORTE;2022-08-25;13;13;0;5;N
IPIAU;532;STC;CORTE;2022-08-25;13;13;0;5;N
IPIAU;531;EPS;CORTE;2022-08-23;7;7;0;3;N
ITAPETINGA;238;EPS;CORTE;2022-08-22;9;9;0;2;N
REMANSO;394;EPS;CORTE;2022-08-22;21;21;0;2;N
TEIXEIRA DE FREITAS;479;STC;CORTE;2022-08-25;5;5;0;5;S
JACOBINA;261;STC;CORTE;2022-08-05;35;0;35;6;N
PITUBA;359;EPS;DISJUNTOR;2022-08-09;1;0;1;3;N
FEIRA DE SANTANA NORTE;111;STC;RECORTE;2022-08-18;5;0;5;5;S
PAULO AFONSO;325;EPS;BAIXA;2022-08-22;11;0;11;2;N
GRACA;129;EPS;CORTE;2022-08-25;21;0;21;5;N
SENHOR DO BONFIM;450;STC;CORTE;2022-08-02;13;12;1;3;N
JUAZEIRO;291;EPS;CORTE;2022-08-09;15;15;0;3;N
PORTO SEGURO;376;EPS;BAIXA;2022-08-04;15;15;0;5;N
FEIRA DE SANTANA NORTE;116;EPS;CORTE;2022-08-19;24;22;2;6;N
PERIPERI;349;STC;CORTE;2022-08-15;11;11;0;2;N
REMANSO;391;EPS;CORTE;2022-08-09;48;47;1;3;N
JACOBINA;256;EPS;CORTE;2022-08-02;7;6;1;3;N
CONCEICAO DO COITE;65;STC;CORTE;2022-08-18;11;10;1;5;N
CANDEIAS;59;STC;CORTE;2022-08-23;16;16;0;3;N
ITABUNA;234;STC;CORTE;2022-08-23;14;13;1;3;N
GRACA;131;STC;RECORTE;2022-08-16;17;11;6;3;N
VITORIA DA CONQUISTA;500;EPS;RECORTE;2022-08-25;15;15;0;5;N
CANDEIAS;533;EPS;CORTE;2022-08-10;19;18;1;4;N
JACOBINA;256;STC;CORTE;2022-08-16;1;1;0;3;N
BARREIRAS;17;EPS;RECORTE;2022-08-10;7;7;0;4;N
JACOBINA;260;EPS;RECORTE;2022-08-04;9;9;0;5;N
FEIRA DE SANTANA NORTE;106;EPS;RECORTE;2022-08-17;3;3;0;4;N
GRACA;132;STC;RECORTE;2022-08-04;17;14;3;5;N
BRUMADO;47;STC;CORTE;2022-08-19;11;11;0;6;N
SENHOR DO BONFIM;448;EPS;CORTE;2022-08-12;6;6;0;6;N
POSTO DA MATA;387;EPS;CORTE;2022-08-15;7;6;1;2;N
PITUBA;359;EPS;BAIXA;2022-08-25;48;38;10;5;S
GRACA;133;EPS;BAIXA;2022-08-25;1;1;0;5;S
CONCEICAO DO COITE;68;EPS;RECORTE;2022-08-18;6;6;0;5;N
PAULO AFONSO;407;EPS;CORTE;2022-08-19;8;8;0;6;N
BOM JESUS DA LAPA;23;STC;RECORTE;2022-08-15;11;10;1;2;N
CONCEICAO DO COITE;67;EPS;DISJUNTOR;2022-08-12;6;6;0;6;N
PITUBA;357;STC;RECORTE;2022-08-16;21;18;3;3;N
SERRINHA;466;EPS;RECORTE;2022-08-05;10;10;0;6;N
ITABERABA;222;EPS;CORTE;2022-08-16;4;4;0;3;N
CANDEIAS;58;EPS;CORTE;2022-08-19;1;1;0;6;S
IBOTIRAMA;168;STC;CORTE;2022-08-09;9;9;0;3;N
CANDEIAS;59;EPS;CORTE;2022-08-09;19;19;0;3;N
RIBEIRA DO POMBAL;409;EPS;CORTE;2022-08-12;10;10;0;6;N
BOM JESUS DA LAPA;34;STC;CORTE;2022-08-05;11;0;11;6;N
VITORIA DA CONQUISTA;513;STC;CORTE;2022-08-05;11;0;11;6;N
IBOTIRAMA;154;STC;CORTE;2022-08-05;9;0;9;6;N
CAMACARI;50;EPS;DISJUNTOR;2022-08-05;25;0;25;6;N
PIRAJA;353;EPS;CORTE;2022-08-05;51;0;51;6;N
IRECE;193;EPS;CORTE;2022-08-05;39;0;39;6;N
RIBEIRA DO POMBAL;399;STC;RECORTE;2022-08-24;11;10;1;4;N
VALENCA;494;EPS;DISJUNTOR;2022-08-25;20;0;20;5;N
SANTA MARIA DA VITORIA;535;EPS;CORTE;2022-08-25;2;0;2;5;N
PERIPERI;347;EPS;CORTE;2022-08-25;26;0;26;5;N
LAURO DE FREITAS;298;EPS;DISJUNTOR;2022-08-08;20;19;1;2;N
SANTO AMARO;424;EPS;RECORTE;2022-08-03;18;18;0;4;N
PERIPERI;347;EPS;DISJUNTOR;2022-08-08;44;42;2;2;N
CAMACARI;57;EPS;CORTE;2022-08-12;10;9;1;6;N
POSTO DA MATA;385;STC;CORTE;2022-08-04;10;9;1;5;N
VITORIA DA CONQUISTA;523;STC;CORTE;2022-08-08;11;11;0;2;N
JACOBINA;260;EPS;BAIXA;2022-08-04;5;5;0;5;N
GRACA;136;EPS;CORTE;2022-08-15;21;20;1;2;N
EUNAPOLIS;87;EPS;RECORTE;2022-08-04;5;4;1;5;N
TEIXEIRA DE FREITAS;469;STC;RECORTE;2022-08-02;17;15;2;3;N
LIVRAMENTO DE NOSSA SENHORA;307;STC;CORTE;2022-08-04;7;7;0;5;N
LAURO DE FREITAS;296;STC;CORTE;2022-08-12;15;15;0;6;S
REMANSO;391;EPS;RECORTE;2022-08-10;42;42;0;4;N
PORTO SEGURO;373;EPS;RECORTE;2022-08-17;17;16;1;4;N
ITABUNA;234;EPS;RECORTE;2022-08-10;7;7;0;4;N
ILHEUS;186;EPS;CORTE;2022-08-08;12;12;0;2;N
BARREIRAS;22;EPS;CORTE;2022-08-23;7;7;0;3;N
IBOTIRAMA;164;STC;CORTE;2022-08-08;9;9;0;2;N
PAULO AFONSO;345;EPS;CORTE;2022-08-04;5;5;0;5;N
SERRINHA;459;STC;CORTE;2022-08-04;11;11;0;5;N
IRECE;207;EPS;RECORTE;2022-08-10;8;7;1;4;N
IRECE;203;EPS;CORTE;2022-08-08;14;14;0;2;N
FEIRA DE SANTANA NORTE;106;EPS;BAIXA;2022-08-17;7;7;0;4;N
LIVRAMENTO DE NOSSA SENHORA;306;EPS;CORTE;2022-08-02;6;6;0;3;N
JUAZEIRO;287;EPS;CORTE;2022-08-08;8;7;1;2;N
SERRINHA;458;EPS;CORTE;2022-08-02;10;10;0;3;N
CANDEIAS;59;STC;RECORTE;2022-08-22;5;4;1;2;S
IRECE;193;STC;RECORTE;2022-08-18;6;5;1;5;S
PERIPERI;349;STC;RECORTE;2022-08-16;38;35;3;3;N
CONCEICAO DO COITE;68;EPS;BAIXA;2022-08-18;2;1;1;5;N
IRECE;194;STC;RECORTE;2022-08-08;10;10;0;2;N
ITABERABA;220;STC;CORTE;2022-08-05;10;0;10;6;N
VALENCA;494;EPS;CORTE;2022-08-19;7;7;0;6;N
JUAZEIRO;287;STC;CORTE;2022-08-22;1;1;0;2;N
IRECE;198;EPS;CORTE;2022-08-19;16;14;2;6;N
ITAPETINGA;248;EPS;CORTE;2022-08-02;11;11;0;3;N
VITORIA DA CONQUISTA;518;STC;CORTE;2022-08-19;11;11;0;6;N
LUIS EDUARDO MAGALHAES;323;STC;CORTE;2022-08-23;42;39;3;3;N
ESPLANADA;78;EPS;CORTE;2022-08-09;17;17;0;3;N
JEQUIE;277;EPS;CORTE;2022-08-23;9;7;2;3;N
BARREIRAS;20;STC;CORTE;2022-08-12;15;15;0;6;N
ILHEUS;183;STC;CORTE;2022-08-09;19;19;0;3;N
ALAGOINHAS;3;STC;RECORTE;2022-08-02;13;4;9;3;S
SANTO AMARO;421;STC;RECORTE;2022-08-02;20;10;10;3;S
EUNAPOLIS;87;EPS;BAIXA;2022-08-04;4;2;2;5;N
JEQUIE;278;EPS;CORTE;2022-08-11;21;21;0;5;N
ITAPOAN;253;EPS;CORTE;2022-08-08;25;24;1;2;N
PAULO AFONSO;340;EPS;CORTE;2022-08-15;8;7;1;2;N
GUANAMBI;142;STC;CORTE;2022-08-11;16;15;1;5;N
ESPLANADA;79;STC;CORTE;2022-08-11;13;13;0;5;N
SANTA MARIA DA VITORIA;418;EPS;CORTE;2022-08-08;10;10;0;2;N
ITABERABA;215;STC;CORTE;2022-08-16;11;11;0;3;N
LIVRAMENTO DE NOSSA SENHORA;306;STC;RECORTE;2022-08-17;4;4;0;4;N
SERRINHA;467;EPS;CORTE;2022-08-17;7;7;0;4;N
AMARGOSA;11;EPS;BAIXA;2022-08-04;16;13;3;5;N
BOM JESUS DA LAPA;33;EPS;BAIXA;2022-08-04;6;6;0;5;N
PAULO AFONSO;325;EPS;CORTE;2022-08-23;8;5;3;3;N
ITABUNA;234;EPS;BAIXA;2022-08-10;3;3;0;4;N
JACOBINA;262;STC;CORTE;2022-08-18;16;15;1;5;N
JACOBINA;261;EPS;CORTE;2022-08-16;8;8;0;3;N
LAURO DE FREITAS;294;EPS;RECORTE;2022-08-25;53;52;1;5;N
JEQUIE;278;STC;CORTE;2022-08-25;11;10;1;5;N
VALENCA;490;EPS;CORTE;2022-08-18;14;13;1;5;N
CAMACARI;52;EPS;CORTE;2022-08-23;19;19;0;3;N
ILHEUS;181;EPS;CORTE;2022-08-19;12;12;0;6;N
SERRINHA;459;STC;RECORTE;2022-08-05;9;0;9;6;N
SERRINHA;468;EPS;CORTE;2022-08-05;8;0;8;6;N
SEABRA;442;EPS;CORTE;2022-08-25;10;0;10;5;N
POSTO DA MATA;378;EPS;CORTE;2022-08-25;5;0;5;5;N
GRACA;137;EPS;BAIXA;2022-08-04;11;9;2;5;N
FEIRA DE SANTANA SUL;123;EPS;CORTE;2022-08-24;54;51;3;4;N
GRACA;135;EPS;CORTE;2022-08-04;100;98;2;5;N
PAULO AFONSO;403;STC;CORTE;2022-08-09;11;11;0;3;N
ITAPOAN;250;STC;CORTE;2022-08-09;19;18;1;3;N
CONCEICAO DO COITE;62;EPS;RECORTE;2022-08-18;6;5;1;5;N
BARREIRAS;15;STC;CORTE;2022-08-23;18;18;0;3;N
FEIRA DE SANTANA SUL;124;EPS;CORTE;2022-08-12;18;13;5;6;N
SANTO AMARO;425;EPS;CORTE;2022-08-15;11;11;0;2;N
TEIXEIRA DE FREITAS;471;STC;CORTE;2022-08-02;17;17;0;3;N
PIRAJA;354;EPS;CORTE;2022-08-18;14;10;4;5;N
ESPLANADA;78;EPS;RECORTE;2022-08-10;14;14;0;4;N
BRUMADO;41;STC;CORTE;2022-08-19;11;10;1;6;N
BARREIRAS;16;STC;CORTE;2022-08-11;15;14;1;5;N
SERRINHA;464;STC;CORTE;2022-08-18;9;9;0;5;N
SEABRA;439;EPS;CORTE;2022-08-12;14;14;0;6;N
ILHEUS;179;STC;CORTE;2022-08-08;11;10;1;2;N
GUANAMBI;153;STC;CORTE;2022-08-02;9;9;0;3;N
FEIRA DE SANTANA SUL;124;STC;CORTE;2022-08-24;20;18;2;4;S
IRECE;194;EPS;CORTE;2022-08-18;9;7;2;5;N
JUAZEIRO;292;EPS;CORTE;2022-08-22;15;15;0;2;N
AMARGOSA;12;EPS;CORTE;2022-08-16;5;5;0;3;N
ITAPOAN;254;STC;RECORTE;2022-08-11;19;19;0;5;N
TEIXEIRA DE FREITAS;469;EPS;CORTE;2022-08-12;11;10;1;6;N
EUNAPOLIS;88;EPS;CORTE;2022-08-16;14;12;2;3;N
VITORIA DA CONQUISTA;507;STC;CORTE;2022-08-05;10;0;10;6;N
BRUMADO;41;EPS;CORTE;2022-08-05;5;0;5;6;N
PORTO SEGURO;376;EPS;CORTE;2022-08-05;16;0;16;6;N
ILHEUS;186;EPS;BAIXA;2022-08-09;17;0;17;3;N
PORTO SEGURO;360;EPS;CORTE;2022-08-25;8;0;8;5;N
SENHOR DO BONFIM;449;EPS;CORTE;2022-08-25;10;0;10;5;N
ITAPETINGA;241;STC;CORTE;2022-08-02;9;8;1;3;N
BRUMADO;37;STC;CORTE;2022-08-18;11;11;0;5;N
PITUBA;359;EPS;DISJUNTOR;2022-08-11;14;14;0;5;N
FEIRA DE SANTANA SUL;123;EPS;RECORTE;2022-08-25;60;40;20;5;N
ALAGOINHAS;4;EPS;CORTE;2022-08-02;22;22;0;3;N
IRECE;205;STC;CORTE;2022-08-23;21;20;1;3;N
ESPLANADA;83;EPS;CORTE;2022-08-23;14;7;7;3;N
SANTO ANTONIO DE JESUS;8;STC;CORTE;2022-08-02;13;13;0;3;N
LUIS EDUARDO MAGALHAES;320;EPS;CORTE;2022-08-22;6;6;0;2;N
BOM JESUS DA LAPA;23;EPS;CORTE;2022-08-02;7;7;0;3;N
PITUBA;356;EPS;CORTE;2022-08-15;60;55;5;2;N
TEIXEIRA DE FREITAS;480;EPS;CORTE;2022-08-03;8;8;0;4;N
GRACA;130;EPS;CORTE;2022-08-15;21;21;0;2;N
BOM JESUS DA LAPA;23;STC;CORTE;2022-08-16;11;11;0;3;N
ITABUNA;172;EPS;CORTE;2022-08-19;15;15;0;6;N
JUAZEIRO;290;STC;CORTE;2022-08-11;11;11;0;5;N
SANTO ANTONIO DE JESUS;431;STC;CORTE;2022-08-02;26;26;0;3;N
IBOTIRAMA;169;STC;RECORTE;2022-08-23;10;8;2;3;N
TEIXEIRA DE FREITAS;479;EPS;CORTE;2022-08-15;11;11;0;2;N
GUANAMBI;147;EPS;CORTE;2022-08-11;7;7;0;5;N
SANTO AMARO;422;STC;CORTE;2022-08-16;9;9;0;3;N
SERRINHA;456;EPS;RECORTE;2022-08-04;7;7;0;5;N
SANTO ANTONIO DE JESUS;432;EPS;RECORTE;2022-08-24;13;6;7;4;S
SANTO ANTONIO DE JESUS;9;EPS;RECORTE;2022-08-24;50;22;28;4;S
LAURO DE FREITAS;298;STC;CORTE;2022-08-15;16;16;0;2;N
BOM JESUS DA LAPA;24;STC;CORTE;2022-08-04;11;11;0;5;N
CAMACARI;52;EPS;BAIXA;2022-08-24;8;8;0;4;N
ESPLANADA;78;EPS;BAIXA;2022-08-10;3;3;0;4;N
CONCEICAO DO COITE;68;EPS;CORTE;2022-08-19;7;7;0;6;N
SENHOR DO BONFIM;453;EPS;BAIXA;2022-08-25;15;14;1;5;S
TEIXEIRA DE FREITAS;484;EPS;RECORTE;2022-08-05;7;7;0;6;N
SANTO ANTONIO DE JESUS;435;STC;RECORTE;2022-08-04;20;18;2;5;N
AMARGOSA;11;EPS;DISJUNTOR;2022-08-11;4;4;0;5;N
VITORIA DA CONQUISTA;502;STC;CORTE;2022-08-16;11;11;0;3;N
SERRINHA;464;STC;RECORTE;2022-08-19;9;8;1;6;N
ESPLANADA;84;STC;CORTE;2022-08-25;11;11;0;5;N
RIBEIRA DO POMBAL;399;STC;CORTE;2022-08-25;11;11;0;5;N
REMANSO;395;EPS;CORTE;2022-08-12;7;7;0;6;N
JUAZEIRO;289;STC;CORTE;2022-08-23;1;1;0;3;N
FEIRA DE SANTANA SUL;124;STC;RECORTE;2022-08-25;20;7;13;5;S
IPIAU;531;EPS;CORTE;2022-08-25;7;0;7;5;N
ITAPETINGA;249;EPS;CORTE;2022-08-15;12;12;0;2;N
BOM JESUS DA LAPA;27;EPS;BAIXA;2022-08-04;6;6;0;5;N
POSTO DA MATA;378;EPS;RECORTE;2022-08-03;12;12;0;4;N
LUIS EDUARDO MAGALHAES;317;STC;CORTE;2022-08-23;21;19;2;3;N
TEIXEIRA DE FREITAS;477;STC;CORTE;2022-08-04;17;17;0;5;N
JACOBINA;256;STC;CORTE;2022-08-18;14;14;0;5;N
PERIPERI;348;EPS;CORTE;2022-08-15;28;27;1;2;N
REMANSO;391;STC;CORTE;2022-08-23;9;9;0;3;S
BOM JESUS DA LAPA;23;EPS;RECORTE;2022-08-03;8;8;0;4;N
REMANSO;390;EPS;CORTE;2022-08-23;10;10;0;3;N
RIBEIRA DO POMBAL;410;STC;CORTE;2022-08-16;11;11;0;3;N
EUNAPOLIS;88;EPS;BAIXA;2022-08-17;4;3;1;4;N
IPIAU;530;STC;CORTE;2022-08-02;13;12;1;3;N
CAMACARI;50;EPS;RECORTE;2022-08-25;44;36;8;5;N
PITUBA;357;STC;RECORTE;2022-08-18;21;21;0;5;N
PORTO SEGURO;360;EPS;CORTE;2022-08-02;8;7;1;3;N
ESPLANADA;83;EPS;RECORTE;2022-08-24;4;3;1;4;N
GRACA;135;EPS;BAIXA;2022-08-05;16;15;1;6;N
LUIS EDUARDO MAGALHAES;317;EPS;CORTE;2022-08-09;7;6;1;3;N
REMANSO;391;EPS;CORTE;2022-08-11;16;14;2;5;N
SENHOR DO BONFIM;449;EPS;CORTE;2022-08-02;8;8;0;3;N
JACOBINA;259;EPS;RECORTE;2022-08-18;9;8;1;5;N
IBOTIRAMA;167;EPS;CORTE;2022-08-09;5;5;0;3;N
LUIS EDUARDO MAGALHAES;318;STC;CORTE;2022-08-11;11;11;0;5;N
VALENCA;486;EPS;BAIXA;2022-08-18;15;13;2;5;N
CANDEIAS;59;STC;CORTE;2022-08-25;7;7;0;5;N
PITUBA;357;STC;RECORTE;2022-08-16;11;5;6;3;S
FEIRA DE SANTANA NORTE;118;STC;CORTE;2022-08-11;1;1;0;5;N
CANDEIAS;58;EPS;CORTE;2022-08-23;42;38;4;3;N
JEQUIE;271;EPS;CORTE;2022-08-23;16;16;0;3;N
JACOBINA;255;EPS;CORTE;2022-08-16;8;2;6;3;N
BOM JESUS DA LAPA;33;EPS;CORTE;2022-08-05;6;0;6;6;N
EUNAPOLIS;87;EPS;CORTE;2022-08-05;6;0;6;6;N
IRECE;205;STC;RECORTE;2022-08-24;21;21;0;4;N
BOM JESUS DA LAPA;28;EPS;CORTE;2022-08-16;5;5;0;3;N
LAURO DE FREITAS;297;STC;CORTE;2022-08-04;16;16;0;5;N
ITABUNA;231;STC;CORTE;2022-08-12;16;14;2;6;N
PAULO AFONSO;332;STC;CORTE;2022-08-04;11;11;0;5;N
LUIS EDUARDO MAGALHAES;317;EPS;RECORTE;2022-08-10;7;6;1;4;N
JUAZEIRO;287;EPS;CORTE;2022-08-10;15;13;2;4;N
GRACA;131;EPS;BAIXA;2022-08-04;11;8;3;5;N
PITUBA;357;EPS;BAIXA;2022-08-04;18;13;5;5;N
GRACA;130;EPS;BAIXA;2022-08-16;16;12;4;3;N
SANTA MARIA DA VITORIA;536;STC;DISJUNTOR;2022-08-10;30;30;0;4;S
LAURO DE FREITAS;296;EPS;CORTE;2022-08-02;15;13;2;3;N
AMARGOSA;6;EPS;CORTE;2022-08-16;5;5;0;3;N
POSTO DA MATA;383;EPS;CORTE;2022-08-16;7;6;1;3;N
ITABERABA;219;STC;CORTE;2022-08-19;21;19;2;6;N
ITAPETINGA;247;STC;CORTE;2022-08-04;9;8;1;5;N
LAURO DE FREITAS;298;EPS;DISJUNTOR;2022-08-10;15;15;0;4;N
IBOTIRAMA;163;EPS;CORTE;2022-08-08;7;7;0;2;N
RIBEIRA DO POMBAL;406;STC;CORTE;2022-08-15;11;10;1;2;N
VALENCA;486;STC;RECORTE;2022-08-09;17;14;3;3;N
REMANSO;390;EPS;RECORTE;2022-08-24;10;10;0;4;N
SENHOR DO BONFIM;449;EPS;RECORTE;2022-08-03;7;7;0;4;N
JUAZEIRO;288;STC;CORTE;2022-08-12;9;7;2;6;N
BOM JESUS DA LAPA;29;STC;CORTE;2022-08-18;11;9;2;5;N
ITABUNA;233;EPS;RECORTE;2022-08-24;11;10;1;4;N
SANTO AMARO;421;STC;CORTE;2022-08-03;20;20;0;4;S
BRUMADO;37;EPS;BAIXA;2022-08-05;6;6;0;6;N
VALENCA;495;EPS;CORTE;2022-08-09;20;19;1;3;N
JEQUIE;269;STC;CORTE;2022-08-12;11;11;0;6;N
RIBEIRA DO POMBAL;410;STC;RECORTE;2022-08-17;4;2;2;4;N
IBOTIRAMA;154;STC;RECORTE;2022-08-08;11;9;2;2;N
VITORIA DA CONQUISTA;522;STC;CORTE;2022-08-22;11;11;0;2;N
IRECE;211;STC;CORTE;2022-08-25;21;18;3;5;N
PERIPERI;349;STC;RECORTE;2022-08-16;7;3;4;3;S
ITABUNA;229;EPS;CORTE;2022-08-22;5;5;0;2;N
JUAZEIRO;286;EPS;CORTE;2022-08-22;11;11;0;2;N
CONCEICAO DO COITE;75;EPS;CORTE;2022-08-09;7;4;3;3;N
PORTO SEGURO;370;EPS;CORTE;2022-08-05;8;0;8;6;N
GRACA;137;EPS;CORTE;2022-08-05;9;0;9;6;N
BARREIRAS;21;STC;CORTE;2022-08-02;15;15;0;3;N
ITABUNA;226;STC;CORTE;2022-08-23;16;16;0;3;N
AMARGOSA;6;EPS;RECORTE;2022-08-17;5;5;0;4;N
ESPLANADA;77;EPS;CORTE;2022-08-23;14;14;0;3;N
ILHEUS;183;STC;CORTE;2022-08-11;19;19;0;5;N
VITORIA DA CONQUISTA;520;EPS;DISJUNTOR;2022-08-15;25;24;1;2;N
SENHOR DO BONFIM;454;EPS;CORTE;2022-08-16;22;22;0;3;N
VITORIA DA CONQUISTA;517;EPS;CORTE;2022-08-19;13;13;0;6;N
VALENCA;491;EPS;CORTE;2022-08-08;20;19;1;2;N
ITABERABA;215;STC;CORTE;2022-08-18;21;20;1;5;N
FEIRA DE SANTANA SUL;128;EPS;CORTE;2022-08-15;18;18;0;2;N
JUAZEIRO;284;STC;CORTE;2022-08-11;9;9;0;5;N
IRECE;200;STC;CORTE;2022-08-11;11;10;1;5;N
IBOTIRAMA;158;EPS;CORTE;2022-08-19;7;7;0;6;N
FEIRA DE SANTANA NORTE;108;EPS;CORTE;2022-08-19;12;12;0;6;N
ESPLANADA;78;EPS;CORTE;2022-08-11;14;14;0;5;N
VALENCA;495;EPS;RECORTE;2022-08-10;11;9;2;4;N
SEABRA;443;EPS;CORTE;2022-08-15;16;16;0;2;N
PORTO SEGURO;366;EPS;CORTE;2022-08-04;7;6;1;5;N
CANDEIAS;58;EPS;BAIXA;2022-08-24;48;44;4;4;N
ITABUNA;233;EPS;BAIXA;2022-08-24;2;2;0;4;N
ITAPETINGA;249;EPS;BAIXA;2022-08-16;7;7;0;3;N
PERIPERI;349;EPS;BAIXA;2022-08-04;12;11;1;5;N
ITABERABA;214;EPS;CORTE;2022-08-16;4;4;0;3;N
BARREIRAS;20;STC;CORTE;2022-08-12;3;3;0;6;S
IBOTIRAMA;160;STC;CORTE;2022-08-09;9;8;1;3;N
LUIS EDUARDO MAGALHAES;323;STC;CORTE;2022-08-25;21;21;0;5;N
ILHEUS;182;EPS;CORTE;2022-08-09;7;6;1;3;N
SEABRA;212;STC;CORTE;2022-08-05;11;0;11;6;N
PAULO AFONSO;341;EPS;CORTE;2022-08-05;9;0;9;6;N
PAULO AFONSO;325;EPS;CORTE;2022-08-25;8;0;8;5;N
GUANAMBI;152;STC;CORTE;2022-08-16;16;16;0;3;N
PORTO SEGURO;375;EPS;CORTE;2022-08-19;10;9;1;6;N
TEIXEIRA DE FREITAS;471;STC;CORTE;2022-08-04;12;11;1;5;N
GUANAMBI;138;STC;CORTE;2022-08-12;16;16;0;6;N
SANTA MARIA DA VITORIA;415;STC;CORTE;2022-08-11;8;8;0;5;N
SEABRA;444;EPS;RECORTE;2022-08-04;4;4;0;5;N
ILHEUS;178;EPS;CORTE;2022-08-08;105;103;2;2;N
IRECE;195;STC;CORTE;2022-08-22;13;13;0;2;N
ITAPOAN;250;STC;CORTE;2022-08-11;19;19;0;5;N
SEABRA;440;STC;CORTE;2022-08-16;11;10;1;3;N
SEABRA;441;STC;CORTE;2022-08-04;11;10;1;5;N
IRECE;199;EPS;RECORTE;2022-08-10;8;8;0;4;N
SENHOR DO BONFIM;454;EPS;RECORTE;2022-08-17;11;10;1;4;N
SANTA MARIA DA VITORIA;414;EPS;CORTE;2022-08-09;8;8;0;3;N
PAULO AFONSO;403;STC;CORTE;2022-08-11;11;11;0;5;N
PORTO SEGURO;361;EPS;CORTE;2022-08-15;9;9;0;2;N
SEABRA;440;EPS;CORTE;2022-08-02;6;6;0;3;N
TEIXEIRA DE FREITAS;470;EPS;CORTE;2022-08-02;11;8;3;3;N
PIRAJA;355;EPS;CORTE;2022-08-08;19;17;2;2;N
ITAPETINGA;244;EPS;BAIXA;2022-08-25;16;15;1;5;S
VITORIA DA CONQUISTA;508;EPS;BAIXA;2022-08-05;17;15;2;6;N
GRACA;136;EPS;BAIXA;2022-08-18;24;18;6;5;N
FEIRA DE SANTANA SUL;125;EPS;CORTE;2022-08-02;18;18;0;3;N
SENHOR DO BONFIM;450;EPS;CORTE;2022-08-15;12;12;0;2;N
LAURO DE FREITAS;294;EPS;BAIXA;2022-08-25;15;12;3;5;S
BRUMADO;42;STC;CORTE;2022-08-09;11;11;0;3;N
PAULO AFONSO;340;EPS;RECORTE;2022-08-16;10;6;4;3;S
VALENCA;486;EPS;CORTE;2022-08-19;7;7;0;6;N
AMARGOSA;6;EPS;BAIXA;2022-08-17;2;2;0;4;N
JUAZEIRO;292;EPS;CORTE;2022-08-24;16;16;0;4;N
LIVRAMENTO DE NOSSA SENHORA;311;EPS;CORTE;2022-08-18;5;5;0;5;N
ESPLANADA;77;EPS;RECORTE;2022-08-24;4;4;0;4;N
ITAPOAN;252;EPS;DISJUNTOR;2022-08-05;30;0;30;6;N
PAULO AFONSO;402;EPS;CORTE;2022-08-09;8;8;0;3;N
IRECE;199;STC;RECORTE;2022-08-24;21;20;1;4;N
VITORIA DA CONQUISTA;521;EPS;BAIXA;2022-08-19;16;0;16;6;S
CAMACARI;56;EPS;BAIXA;2022-08-25;1;0;1;5;S
IBOTIRAMA;165;STC;CORTE;2022-08-23;14;14;0;3;N
CAMACARI;52;EPS;CORTE;2022-08-02;18;16;2;3;N
PIRAJA;353;EPS;DISJUNTOR;2022-08-15;17;17;0;2;N
SANTO AMARO;422;STC;CORTE;2022-08-18;21;21;0;5;N
SENHOR DO BONFIM;447;STC;CORTE;2022-08-16;11;11;0;3;N
ITAPOAN;253;EPS;BAIXA;2022-08-11;13;11;2;5;N
LUIS EDUARDO MAGALHAES;323;STC;CORTE;2022-08-02;11;11;0;3;N
IPIAU;532;EPS;CORTE;2022-08-15;7;7;0;2;N
VITORIA DA CONQUISTA;502;STC;CORTE;2022-08-18;11;11;0;5;N
PITUBA;357;STC;CORTE;2022-08-19;19;18;1;6;N
SANTO AMARO;422;EPS;CORTE;2022-08-04;30;28;2;5;N
IRECE;205;EPS;CORTE;2022-08-11;13;13;0;5;N
BOM JESUS DA LAPA;23;EPS;CORTE;2022-08-04;14;14;0;5;N
ALAGOINHAS;3;EPS;CORTE;2022-08-16;10;10;0;3;N
ALAGOINHAS;4;EPS;CORTE;2022-08-04;22;21;1;5;N
ILHEUS;178;STC;RECORTE;2022-08-23;21;21;0;3;N
IBOTIRAMA;166;STC;CORTE;2022-08-11;9;9;0;5;N
SANTA MARIA DA VITORIA;414;EPS;RECORTE;2022-08-10;5;5;0;4;N
SANTO ANTONIO DE JESUS;431;STC;CORTE;2022-08-04;13;13;0;5;N
PORTO SEGURO;371;EPS;CORTE;2022-08-18;10;8;2;5;N
EUNAPOLIS;99;STC;CORTE;2022-08-23;14;14;0;3;N
JUAZEIRO;292;EPS;RECORTE;2022-08-25;11;8;3;5;N
ITAPETINGA;241;STC;CORTE;2022-08-04;9;9;0;5;N
CAMACARI;53;STC;CORTE;2022-08-02;20;20;0;3;S
GUANAMBI;152;STC;RECORTE;2022-08-17;6;6;0;4;N
LUIS EDUARDO MAGALHAES;321;EPS;CORTE;2022-08-12;7;6;1;6;N
IRECE;205;STC;CORTE;2022-08-25;21;21;0;5;N
PERIPERI;348;EPS;DISJUNTOR;2022-08-23;28;27;1;3;N
PAULO AFONSO;332;EPS;CORTE;2022-08-15;8;7;1;2;N
ITAPOAN;250;STC;RECORTE;2022-08-12;19;7;12;6;N
TEIXEIRA DE FREITAS;471;STC;RECORTE;2022-08-05;17;0;17;6;N
ITABERABA;213;EPS;CORTE;2022-08-05;6;0;6;6;N
PITUBA;357;EPS;CORTE;2022-08-05;21;0;21;6;N
GRACA;131;EPS;CORTE;2022-08-05;10;0;10;6;N
GUANAMBI;146;EPS;CORTE;2022-08-25;4;0;4;5;N
ESPLANADA;83;EPS;CORTE;2022-08-25;13;0;13;5;N
SANTO ANTONIO DE JESUS;426;STC;CORTE;2022-08-15;13;13;0;2;N
RIBEIRA DO POMBAL;409;EPS;CORTE;2022-08-16;10;10;0;3;N
SANTO AMARO;421;EPS;RECORTE;2022-08-17;21;21;0;4;N
IPIAU;530;STC;CORTE;2022-08-04;13;13;0;5;N
VALENCA;493;STC;CORTE;2022-08-23;17;17;0;3;N
ITABUNA;235;STC;CORTE;2022-08-15;16;16;0;2;N
CONCEICAO DO COITE;65;EPS;CORTE;2022-08-08;8;8;0;2;N
CAMACARI;50;EPS;DISJUNTOR;2022-08-09;25;19;6;3;N
PORTO SEGURO;373;STC;RECORTE;2022-08-09;21;16;5;3;N
BOM JESUS DA LAPA;23;EPS;RECORTE;2022-08-05;8;8;0;6;N
VALENCA;494;STC;CORTE;2022-08-11;11;11;0;5;N
IRECE;202;STC;CORTE;2022-08-12;11;11;0;6;N
LUIS EDUARDO MAGALHAES;317;EPS;CORTE;2022-08-11;7;6;1;5;N
ITABUNA;184;EPS;BAIXA;2022-08-24;5;5;0;4;N
SANTO AMARO;419;EPS;DISJUNTOR;2022-08-23;4;4;0;3;N
TEIXEIRA DE FREITAS;481;STC;RECORTE;2022-08-08;17;14;3;2;N
FEIRA DE SANTANA SUL;123;EPS;BAIXA;2022-08-25;55;50;5;5;S
VITORIA DA CONQUISTA;511;EPS;CORTE;2022-08-19;14;14;0;6;N
PIRAJA;351;STC;RECORTE;2022-08-22;17;13;4;2;N
ALAGOINHAS;4;STC;RECORTE;2022-08-19;16;12;4;6;N
LUIS EDUARDO MAGALHAES;317;STC;CORTE;2022-08-25;21;21;0;5;N
ILHEUS;183;EPS;CORTE;2022-08-22;25;25;0;2;N
BOM JESUS DA LAPA;32;EPS;CORTE;2022-08-19;5;5;0;6;N
ALAGOINHAS;3;EPS;RECORTE;2022-08-17;14;13;1;4;N
PORTO SEGURO;360;EPS;CORTE;2022-08-04;8;8;0;5;N
VALENCA;496;EPS;DISJUNTOR;2022-08-05;4;0;4;6;N
ALAGOINHAS;1;STC;CORTE;2022-08-05;1;0;1;6;N
PERIPERI;349;EPS;CORTE;2022-08-05;10;0;10;6;N
JACOBINA;257;EPS;BAIXA;2022-08-18;1;0;1;5;N
ITABUNA;233;EPS;CORTE;2022-08-25;25;0;25;5;N
JUAZEIRO;287;EPS;CORTE;2022-08-12;13;13;0;6;N
FEIRA DE SANTANA SUL;123;EPS;RECORTE;2022-08-04;48;45;3;5;N
IBOTIRAMA;163;EPS;CORTE;2022-08-10;10;9;1;4;N
VITORIA DA CONQUISTA;502;EPS;BAIXA;2022-08-05;17;17;0;6;N
REMANSO;389;STC;CORTE;2022-08-02;9;8;1;3;N
GRACA;136;EPS;CORTE;2022-08-19;63;62;1;6;N
SERRINHA;459;STC;CORTE;2022-08-08;11;11;0;2;N
SANTA MARIA DA VITORIA;417;STC;CORTE;2022-08-10;20;20;0;4;S
SANTA MARIA DA VITORIA;536;EPS;RECORTE;2022-08-16;7;6;1;3;S
RIBEIRA DO POMBAL;397;STC;RECORTE;2022-08-03;10;10;0;4;N
CANDEIAS;58;EPS;DISJUNTOR;2022-08-08;27;26;1;2;N
BRUMADO;43;STC;CORTE;2022-08-22;11;11;0;2;N
LAURO DE FREITAS;295;EPS;CORTE;2022-08-16;16;16;0;3;N
SANTO ANTONIO DE JESUS;426;STC;RECORTE;2022-08-16;16;14;2;3;N
IRECE;193;EPS;RECORTE;2022-08-10;24;24;0;4;N
SANTA MARIA DA VITORIA;417;STC;CORTE;2022-08-12;11;10;1;6;N
BRUMADO;47;EPS;RECORTE;2022-08-10;4;4;0;4;N
RIBEIRA DO POMBAL;405;EPS;CORTE;2022-08-15;10;10;0;2;N
ITABUNA;233;EPS;RECORTE;2022-08-24;20;15;5;4;S
ALAGOINHAS;3;EPS;BAIXA;2022-08-17;6;4;2;4;N
PITUBA;356;EPS;BAIXA;2022-08-18;6;5;1;5;N
PERIPERI;347;EPS;DISJUNTOR;2022-08-12;46;44;2;6;N
ITABERABA;218;EPS;CORTE;2022-08-19;3;3;0;6;N
LIVRAMENTO DE NOSSA SENHORA;305;EPS;CORTE;2022-08-18;6;5;1;5;N
BOM JESUS DA LAPA;33;STC;RECORTE;2022-08-22;16;13;3;2;N
SANTA MARIA DA VITORIA;415;EPS;CORTE;2022-08-22;2;2;0;2;N
TEIXEIRA DE FREITAS;485;EPS;CORTE;2022-08-19;10;8;2;6;N
BOM JESUS DA LAPA;28;EPS;CORTE;2022-08-18;5;5;0;5;N
VALENCA;497;EPS;BAIXA;2022-08-11;31;29;2;5;N
ALAGOINHAS;4;EPS;BAIXA;2022-08-05;11;8;3;6;N
SANTO AMARO;422;EPS;BAIXA;2022-08-05;14;14;0;6;N
IRECE;211;STC;CORTE;2022-08-25;6;6;0;5;S
ITABUNA;231;STC;CORTE;2022-08-12;3;3;0;6;S
LAURO DE FREITAS;296;STC;CORTE;2022-08-16;5;5;0;3;S
VALENCA;490;EPS;CORTE;2022-08-22;24;23;1;2;N
JACOBINA;262;EPS;CORTE;2022-08-08;11;10;1;2;N
EUNAPOLIS;93;EPS;CORTE;2022-08-09;12;12;0;3;N
CONCEICAO DO COITE;72;STC;CORTE;2022-08-12;11;10;1;6;N
SANTO ANTONIO DE JESUS;435;EPS;RECORTE;2022-08-17;6;6;0;4;N
BARREIRAS;21;STC;CORTE;2022-08-04;15;15;0;5;N
SENHOR DO BONFIM;454;EPS;CORTE;2022-08-18;20;18;2;5;N
FEIRA DE SANTANA NORTE;109;EPS;CORTE;2022-08-09;180;168;12;3;N
LAURO DE FREITAS;293;STC;CORTE;2022-08-03;8;8;0;4;S
BARREIRAS;20;STC;CORTE;2022-08-16;15;11;4;3;N
VITORIA DA CONQUISTA;518;STC;CORTE;2022-08-23;11;8;3;3;N
VITORIA DA CONQUISTA;518;EPS;CORTE;2022-08-09;15;15;0;3;N
GRACA;134;STC;CORTE;2022-08-08;7;6;1;2;N
BARREIRAS;20;EPS;CORTE;2022-08-02;9;8;1;3;N
IBOTIRAMA;163;EPS;RECORTE;2022-08-11;7;7;0;5;N
ESPLANADA;83;EPS;RECORTE;2022-08-03;9;9;0;4;N
LAURO DE FREITAS;296;EPS;RECORTE;2022-08-05;16;16;0;6;N
IRECE;199;EPS;CORTE;2022-08-11;13;11;2;5;N
ITABERABA;216;STC;CORTE;2022-08-08;6;6;0;2;N
ITABUNA;226;STC;CORTE;2022-08-25;16;16;0;5;N
LAURO DE FREITAS;297;STC;RECORTE;2022-08-05;8;6;2;6;S
ITABUNA;225;EPS;CORTE;2022-08-23;10;10;0;3;N
GRACA;132;EPS;CORTE;2022-08-18;21;17;4;5;N
SERRINHA;468;EPS;CORTE;2022-08-09;6;5;1;3;N
PAULO AFONSO;328;STC;CORTE;2022-08-05;11;0;11;6;N
LAURO DE FREITAS;293;STC;CORTE;2022-08-05;16;0;16;6;N
LIVRAMENTO DE NOSSA SENHORA;302;EPS;CORTE;2022-08-05;3;0;3;6;N
ITABUNA;230;STC;RECORTE;2022-08-25;14;9;5;5;S
IPIAU;190;EPS;CORTE;2022-08-25;7;0;7;5;N
LUIS EDUARDO MAGALHAES;322;EPS;CORTE;2022-08-25;7;0;7;5;N
PORTO SEGURO;376;EPS;CORTE;2022-08-09;16;14;2;3;N
LAURO DE FREITAS;296;EPS;BAIXA;2022-08-05;17;14;3;6;N
ILHEUS;178;EPS;CORTE;2022-08-10;66;64;2;4;N
IBOTIRAMA;155;STC;CORTE;2022-08-22;16;14;2;2;N
JACOBINA;259;STC;CORTE;2022-08-09;15;14;1;3;N
JEQUIE;275;EPS;CORTE;2022-08-02;18;18;0;3;N
FEIRA DE SANTANA SUL;128;EPS;RECORTE;2022-08-18;14;11;3;5;N
BARREIRAS;16;STC;CORTE;2022-08-15;15;15;0;2;N
FEIRA DE SANTANA SUL;124;EPS;CORTE;2022-08-16;18;17;1;3;N
CAMACARI;50;STC;CORTE;2022-08-16;48;47;1;3;N
PIRAJA;354;EPS;CORTE;2022-08-22;26;25;1;2;N
IRECE;211;STC;CORTE;2022-08-04;11;10;1;5;N
JEQUIE;275;STC;CORTE;2022-08-16;11;11;0;3;N
BARREIRAS;20;EPS;RECORTE;2022-08-03;8;8;0;4;N
IRECE;198;EPS;RECORTE;2022-08-24;15;14;1;4;N
PAULO AFONSO;341;EPS;RECORTE;2022-08-08;18;18;0;2;N
IRECE;195;STC;CORTE;2022-08-22;14;14;0;2;S
REMANSO;395;STC;CORTE;2022-08-04;8;8;0;5;N
FEIRA DE SANTANA NORTE;110;STC;RECORTE;2022-08-12;2;2;0;6;N
IRECE;200;STC;RECORTE;2022-08-12;12;10;2;6;S
JACOBINA;263;STC;RECORTE;2022-08-09;4;2;2;3;S
LIVRAMENTO DE NOSSA SENHORA;312;EPS;CORTE;2022-08-08;5;5;0;2;N
ILHEUS;180;EPS;DISJUNTOR;2022-08-18;1;1;0;5;N
JACOBINA;257;EPS;CORTE;2022-08-19;8;8;0;6;N
SANTA MARIA DA VITORIA;414;EPS;CORTE;2022-08-11;8;8;0;5;N
IRECE;194;EPS;CORTE;2022-08-22;3;3;0;2;N
LIVRAMENTO DE NOSSA SENHORA;303;STC;RECORTE;2022-08-08;8;8;0;2;N
ITAPETINGA;244;EPS;CORTE;2022-08-05;14;0;14;6;N
SENHOR DO BONFIM;451;EPS;CORTE;2022-08-05;7;0;7;6;N
SEABRA;440;EPS;CORTE;2022-08-04;6;6;0;5;N
PAULO AFONSO;324;STC;CORTE;2022-08-04;1;1;0;5;N
SENHOR DO BONFIM;447;STC;CORTE;2022-08-18;12;12;0;5;N
TEIXEIRA DE FREITAS;479;EPS;CORTE;2022-08-19;10;10;0;6;N
ITABUNA;226;STC;CORTE;2022-08-02;16;15;1;3;N
ESPLANADA;84;EPS;CORTE;2022-08-15;13;13;0;2;N
PERIPERI;347;STC;CORTE;2022-08-19;16;15;1;6;N
VALENCA;487;EPS;RECORTE;2022-08-10;13;13;0;4;N
SENHOR DO BONFIM;446;EPS;CORTE;2022-08-16;11;11;0;3;N
PIRAJA;352;STC;CORTE;2022-08-09;16;16;0;3;S
POSTO DA MATA;385;EPS;CORTE;2022-08-19;13;13;0;6;N
BRUMADO;37;STC;CORTE;2022-08-22;11;11;0;2;N
RIBEIRA DO POMBAL;400;EPS;CORTE;2022-08-03;10;10;0;4;N
LAURO DE FREITAS;298;STC;CORTE;2022-08-19;16;15;1;6;N
ALAGOINHAS;3;EPS;CORTE;2022-08-18;10;9;1;5;N
TEIXEIRA DE FREITAS;481;STC;CORTE;2022-08-09;17;14;3;3;N
FEIRA DE SANTANA SUL;121;EPS;CORTE;2022-08-03;14;14;0;4;N
EUNAPOLIS;88;EPS;DISJUNTOR;2022-08-03;16;16;0;4;N
PITUBA;358;STC;CORTE;2022-08-09;19;19;0;3;N
POSTO DA MATA;387;STC;CORTE;2022-08-09;17;14;3;3;N
PITUBA;356;EPS;CORTE;2022-08-19;36;34;2;6;N
BOM JESUS DA LAPA;24;STC;CORTE;2022-08-08;11;11;0;2;N
RIBEIRA DO POMBAL;399;EPS;CORTE;2022-08-15;10;10;0;2;N
IBOTIRAMA;155;STC;RECORTE;2022-08-23;16;16;0;3;N
SANTO ANTONIO DE JESUS;430;EPS;CORTE;2022-08-04;6;6;0;5;N
PIRAJA;352;STC;CORTE;2022-08-11;17;17;0;5;N
EUNAPOLIS;86;STC;CORTE;2022-08-09;21;21;0;3;N
AMARGOSA;11;EPS;DISJUNTOR;2022-08-15;3;3;0;2;N
PORTO SEGURO;376;EPS;RECORTE;2022-08-10;42;42;0;4;N
FEIRA DE SANTANA SUL;125;EPS;RECORTE;2022-08-05;53;53;0;6;N
IRECE;206;STC;CORTE;2022-08-15;11;10;1;2;N
VALENCA;491;EPS;BAIXA;2022-08-11;17;17;0;5;N
ITABUNA;225;EPS;BAIXA;2022-08-24;2;2;0;4;N
SANTO AMARO;421;EPS;CORTE;2022-08-18;10;10;0;5;N
ILHEUS;178;STC;RECORTE;2022-08-23;13;10;3;3;S
FEIRA DE SANTANA NORTE;115;STC;CORTE;2022-08-25;19;19;0;5;N
PITUBA;359;EPS;DISJUNTOR;2022-08-15;2;2;0;2;N
PIRAJA;354;EPS;DISJUNTOR;2022-08-05;15;0;15;6;N
FEIRA DE SANTANA SUL;122;STC;CORTE;2022-08-05;2;0;2;6;N
ILHEUS;178;STC;RECORTE;2022-08-25;18;13;5;5;N
JACOBINA;264;STC;CORTE;2022-08-23;13;13;0;3;N
ITABUNA;226;STC;RECORTE;2022-08-03;16;16;0;4;N
JACOBINA;256;EPS;CORTE;2022-08-08;11;11;0;2;N
ILHEUS;186;STC;CORTE;2022-08-02;16;16;0;3;N
CANDEIAS;59;EPS;CORTE;2022-08-15;18;17;1;2;N
LUIS EDUARDO MAGALHAES;318;STC;CORTE;2022-08-15;11;11;0;2;N
VALENCA;492;EPS;CORTE;2022-08-23;21;20;1;3;N
VALENCA;496;EPS;RECORTE;2022-08-25;23;22;1;5;N
IRECE;201;STC;CORTE;2022-08-24;7;7;0;4;S
PITUBA;357;STC;RECORTE;2022-08-22;21;18;3;2;N
SANTO ANTONIO DE JESUS;429;EPS;RECORTE;2022-08-17;6;5;1;4;N
ITABUNA;185;STC;CORTE;2022-08-04;14;14;0;5;N
ILHEUS;178;EPS;BAIXA;2022-08-11;18;15;3;5;N
PIRAJA;355;EPS;BAIXA;2022-08-11;28;20;8;5;N
LUIS EDUARDO MAGALHAES;323;STC;RECORTE;2022-08-03;5;4;1;4;S
SANTO AMARO;422;STC;RECORTE;2022-08-19;9;5;4;6;S
REMANSO;392;EPS;BAIXA;2022-08-25;24;24;0;5;S
JUAZEIRO;290;STC;RECORTE;2022-08-16;16;10;6;3;N
VALENCA;493;STC;CORTE;2022-08-25;17;17;0;5;N
ITAPETINGA;249;EPS;CORTE;2022-08-19;8;7;1;6;N
VALENCA;493;EPS;CORTE;2022-08-11;7;7;0;5;N
IRECE;195;EPS;BAIXA;2022-08-11;14;14;0;5;N
FEIRA DE SANTANA SUL;125;EPS;BAIXA;2022-08-05;8;6;2;6;N
REMANSO;390;EPS;CORTE;2022-08-25;1;1;0;5;S
BOM JESUS DA LAPA;33;EPS;CORTE;2022-08-09;5;5;0;3;N
ITAPOAN;254;EPS;CORTE;2022-08-25;20;0;20;5;N
PAULO AFONSO;407;EPS;CORTE;2022-08-25;5;0;5;5;N
SERRINHA;458;EPS;CORTE;2022-08-08;16;16;0;2;N
IRECE;211;EPS;CORTE;2022-08-15;13;13;0;2;N
BOM JESUS DA LAPA;29;EPS;CORTE;2022-08-08;7;6;1;2;N
ITABUNA;231;STC;CORTE;2022-08-16;16;15;1;3;N
ITABUNA;184;STC;RECORTE;2022-08-17;16;9;7;4;N
VITORIA DA CONQUISTA;524;STC;CORTE;2022-08-02;11;11;0;3;N
JUAZEIRO;288;EPS;CORTE;2022-08-02;8;8;0;3;N
ITABUNA;236;STC;RECORTE;2022-08-04;40;20;20;5;S
BRUMADO;42;EPS;CORTE;2022-08-22;6;6;0;2;N
VITORIA DA CONQUISTA;508;STC;CORTE;2022-08-22;11;11;0;2;N
RIBEIRA DO POMBAL;406;STC;CORTE;2022-08-19;11;11;0;6;N
ITABUNA;232;STC;CORTE;2022-08-04;14;14;0;5;N
CANDEIAS;58;EPS;DISJUNTOR;2022-08-10;21;18;3;4;N
IBOTIRAMA;163;EPS;CORTE;2022-08-12;7;6;1;6;N
CONCEICAO DO COITE;62;STC;CORTE;2022-08-11;10;10;0;5;N
RIBEIRA DO POMBAL;405;EPS;CORTE;2022-08-17;10;8;2;4;N
FEIRA DE SANTANA NORTE;112;EPS;CORTE;2022-08-24;15;14;1;4;N
ITAPETINGA;247;STC;CORTE;2022-08-08;9;9;0;2;N
ITABUNA;184;EPS;RECORTE;2022-08-03;17;16;1;4;N
BOM JESUS DA LAPA;33;EPS;RECORTE;2022-08-10;8;7;1;4;N
VITORIA DA CONQUISTA;508;EPS;CORTE;2022-08-08;20;18;2;2;N
FEIRA DE SANTANA SUL;127;STC;CORTE;2022-08-19;1;1;0;6;N
LUIS EDUARDO MAGALHAES;313;EPS;CORTE;2022-08-12;4;3;1;6;N
TEIXEIRA DE FREITAS;472;STC;CORTE;2022-08-19;15;14;1;6;N
BRUMADO;46;EPS;RECORTE;2022-08-24;3;3;0;4;N
GRACA;137;EPS;CORTE;2022-08-09;21;19;2;3;N
ITAPETINGA;245;EPS;CORTE;2022-08-18;10;10;0;5;N
SANTO ANTONIO DE JESUS;435;EPS;CORTE;2022-08-18;4;4;0;5;N
LUIS EDUARDO MAGALHAES;318;STC;RECORTE;2022-08-16;13;13;0;3;N
IRECE;197;STC;CORTE;2022-08-25;21;21;0;5;N
ILHEUS;180;STC;CORTE;2022-08-25;21;20;1;5;N
PORTO SEGURO;377;EPS;CORTE;2022-08-22;9;8;1;2;N
ITABERABA;219;EPS;CORTE;2022-08-09;5;5;0;3;N
SENHOR DO BONFIM;445;EPS;CORTE;2022-08-05;6;0;6;6;N
JUAZEIRO;284;STC;CORTE;2022-08-15;9;9;0;2;N
SANTO ANTONIO DE JESUS;9;STC;CORTE;2022-08-19;13;13;0;6;N
REMANSO;392;EPS;BAIXA;2022-08-04;12;9;3;5;N
GRACA;133;EPS;CORTE;2022-08-08;53;50;3;2;N
FEIRA DE SANTANA NORTE;108;EPS;CORTE;2022-08-23;16;15;1;3;N
PITUBA;359;STC;CORTE;2022-08-22;19;18;1;2;N
VITORIA DA CONQUISTA;520;EPS;DISJUNTOR;2022-08-19;28;27;1;6;N
RIBEIRA DO POMBAL;405;EPS;RECORTE;2022-08-18;11;10;1;5;N
JACOBINA;263;STC;CORTE;2022-08-12;16;15;1;6;N
VALENCA;491;EPS;CORTE;2022-08-12;14;14;0;6;N
ITAPETINGA;242;STC;CORTE;2022-08-17;18;18;0;4;S
JACOBINA;262;EPS;CORTE;2022-08-10;9;9;0;4;N
FEIRA DE SANTANA NORTE;109;EPS;CORTE;2022-08-11;40;37;3;5;N
BARREIRAS;20;EPS;CORTE;2022-08-04;8;7;1;5;N
ITABERABA;215;STC;CORTE;2022-08-22;21;19;2;2;N
CAMACARI;53;EPS;CORTE;2022-08-17;21;20;1;4;N
ITAPETINGA;241;EPS;CORTE;2022-08-17;12;12;0;4;N
VITORIA DA CONQUISTA;521;EPS;RECORTE;2022-08-25;16;5;11;5;N
ITAPETINGA;242;STC;CORTE;2022-08-19;9;7;2;6;N
BRUMADO;39;STC;CORTE;2022-08-23;11;11;0;3;N
ITABERABA;215;EPS;CORTE;2022-08-08;6;6;0;2;N
LIVRAMENTO DE NOSSA SENHORA;301;EPS;CORTE;2022-08-19;6;6;0;6;N
REMANSO;389;STC;RECORTE;2022-08-03;8;5;3;4;S
ITABUNA;231;STC;RECORTE;2022-08-17;21;10;11;4;N
POSTO DA MATA;385;STC;RECORTE;2022-08-09;11;5;6;3;S
FEIRA DE SANTANA NORTE;112;EPS;RECORTE;2022-08-25;36;35;1;5;N
BOM JESUS DA LAPA;33;EPS;BAIXA;2022-08-10;4;4;0;4;N
IBOTIRAMA;159;STC;CORTE;2022-08-25;16;15;1;5;N
SANTA MARIA DA VITORIA;412;STC;CORTE;2022-08-25;16;16;0;5;N
LUIS EDUARDO MAGALHAES;323;EPS;CORTE;2022-08-15;7;7;0;2;N
JACOBINA;261;EPS;CORTE;2022-08-22;8;8;0;2;N
JEQUIE;279;EPS;CORTE;2022-08-05;6;0;6;6;N
SENHOR DO BONFIM;450;EPS;CORTE;2022-08-19;20;20;0;6;N
FEIRA DE SANTANA NORTE;106;STC;CORTE;2022-08-12;18;17;1;6;N
ITAPOAN;254;EPS;RECORTE;2022-08-03;36;36;0;4;N
VALENCA;486;EPS;CORTE;2022-08-23;7;7;0;3;N
IBOTIRAMA;170;EPS;CORTE;2022-08-02;3;3;0;3;N
GUANAMBI;138;STC;CORTE;2022-08-16;16;15;1;3;N
IPIAU;188;EPS;CORTE;2022-08-02;11;11;0;3;N
ILHEUS;180;STC;CORTE;2022-08-02;21;20;1;3;N
JUAZEIRO;284;STC;RECORTE;2022-08-16;16;16;0;3;N
GUANAMBI;142;EPS;RECORTE;2022-08-04;40;40;0;5;N
SERRINHA;463;EPS;CORTE;2022-08-22;6;6;0;2;N
IRECE;195;EPS;CORTE;2022-08-12;13;13;0;6;N
PIRAJA;355;EPS;CORTE;2022-08-12;48;45;3;6;N
IPIAU;188;STC;CORTE;2022-08-16;19;17;2;3;N
IBOTIRAMA;170;STC;CORTE;2022-08-16;8;8;0;3;N
IBOTIRAMA;155;EPS;CORTE;2022-08-10;10;10;0;4;N
CONCEICAO DO COITE;66;EPS;CORTE;2022-08-23;6;5;1;3;N
GUANAMBI;138;EPS;CORTE;2022-08-02;7;7;0;3;N
SEABRA;441;STC;CORTE;2022-08-08;5;5;0;2;N
CAMACARI;50;STC;CORTE;2022-08-16;20;20;0;3;S
IRECE;210;EPS;CORTE;2022-08-04;8;8;0;5;N
PAULO AFONSO;341;EPS;RECORTE;2022-08-10;12;10;2;4;N
LUIS EDUARDO MAGALHAES;320;STC;CORTE;2022-08-16;11;10;1;3;N
JACOBINA;258;STC;CORTE;2022-08-23;16;16;0;3;N
JACOBINA;258;EPS;CORTE;2022-08-09;9;9;0;3;N
VITORIA DA CONQUISTA;515;STC;CORTE;2022-08-12;11;11;0;6;N
FEIRA DE SANTANA NORTE;108;EPS;RECORTE;2022-08-24;8;7;1;4;N
EUNAPOLIS;88;EPS;CORTE;2022-08-22;3;3;0;2;N
LIVRAMENTO DE NOSSA SENHORA;311;EPS;CORTE;2022-08-22;5;4;1;2;N
SERRINHA;465;STC;CORTE;2022-08-12;11;11;0;6;N
SENHOR DO BONFIM;452;STC;CORTE;2022-08-09;11;9;2;3;N
BARREIRAS;15;EPS;CORTE;2022-08-15;7;7;0;2;N
PAULO AFONSO;328;STC;RECORTE;2022-08-08;11;11;0;2;N
CAMACARI;55;STC;RECORTE;2022-08-08;16;13;3;2;N
IBOTIRAMA;171;STC;CORTE;2022-08-04;7;7;0;5;N
AMARGOSA;12;EPS;CORTE;2022-08-22;5;5;0;2;N
ITABUNA;185;EPS;CORTE;2022-08-15;6;6;0;2;N
REMANSO;393;EPS;CORTE;2022-08-16;20;19;1;3;N
GRACA;136;EPS;BAIXA;2022-08-22;15;0;15;2;N
ALAGOINHAS;4;EPS;CORTE;2022-08-08;23;21;2;2;N
PITUBA;357;EPS;CORTE;2022-08-09;20;19;1;3;N
SENHOR DO BONFIM;448;STC;CORTE;2022-08-08;13;13;0;2;N
SANTO AMARO;422;EPS;CORTE;2022-08-08;30;27;3;2;N
SANTO ANTONIO DE JESUS;8;STC;CORTE;2022-08-08;13;13;0;2;N
SANTA MARIA DA VITORIA;412;STC;CORTE;2022-08-02;11;11;0;3;N
JUAZEIRO;290;EPS;CORTE;2022-08-03;22;22;0;4;N
PIRAJA;351;EPS;CORTE;2022-08-11;16;15;1;5;N
BOM JESUS DA LAPA;31;STC;CORTE;2022-08-23;16;14;2;3;N
PORTO SEGURO;373;STC;CORTE;2022-08-12;21;20;1;6;N
PERIPERI;348;STC;CORTE;2022-08-09;32;30;2;3;N
SERRINHA;464;EPS;RECORTE;2022-08-11;14;14;0;5;N
POSTO DA MATA;386;EPS;CORTE;2022-08-09;7;7;0;3;N
PIRAJA;350;EPS;CORTE;2022-08-23;13;12;1;3;N
POSTO DA MATA;387;STC;CORTE;2022-08-11;15;14;1;5;N
BOM JESUS DA LAPA;23;EPS;CORTE;2022-08-08;14;14;0;2;N
PAULO AFONSO;332;EPS;CORTE;2022-08-19;8;8;0;6;N
ILHEUS;180;STC;RECORTE;2022-08-03;21;21;0;4;N
ITABERABA;222;STC;CORTE;2022-08-12;11;10;1;6;N
ITABUNA;225;EPS;CORTE;2022-08-02;10;9;1;3;N
PAULO AFONSO;334;STC;CORTE;2022-08-09;4;3;1;3;N
SEABRA;441;STC;RECORTE;2022-08-09;13;9;4;3;N
IPIAU;188;EPS;RECORTE;2022-08-03;8;8;0;4;N
IRECE;205;EPS;CORTE;2022-08-15;13;13;0;2;N
FEIRA DE SANTANA NORTE;108;EPS;BAIXA;2022-08-24;4;4;0;4;N
ITAPETINGA;239;EPS;CORTE;2022-08-18;10;10;0;5;N
VALENCA;487;EPS;RECORTE;2022-08-12;15;15;0;6;N
GUANAMBI;138;STC;RECORTE;2022-08-17;21;20;1;4;N
ILHEUS;177;EPS;RECORTE;2022-08-25;17;17;0;5;N
REMANSO;393;EPS;RECORTE;2022-08-17;4;4;0;4;N
CAMACARI;50;STC;RECORTE;2022-08-19;16;6;10;6;N
JEQUIE;275;EPS;RECORTE;2022-08-05;5;5;0;6;N
ILHEUS;173;EPS;CORTE;2022-08-23;26;25;1;3;N
ITABERABA;220;EPS;CORTE;2022-08-22;4;4;0;2;N
PORTO SEGURO;371;EPS;CORTE;2022-08-22;9;9;0;2;N
JUAZEIRO;291;STC;CORTE;2022-08-05;9;0;9;6;N
IRECE;207;STC;CORTE;2022-08-05;11;0;11;6;N
EUNAPOLIS;88;EPS;DISJUNTOR;2022-08-05;8;0;8;6;N
GUANAMBI;148;EPS;CORTE;2022-08-05;7;0;7;6;N
RIBEIRA DO POMBAL;400;EPS;CORTE;2022-08-05;13;0;13;6;N
FEIRA DE SANTANA SUL;121;EPS;CORTE;2022-08-05;7;0;7;6;N
FEIRA DE SANTANA SUL;121;STC;CORTE;2022-08-19;1;1;0;6;N
EUNAPOLIS;89;STC;RECORTE;2022-08-25;1;1;0;5;N
GRACA;132;EPS;BAIXA;2022-08-19;19;0;19;6;S
EUNAPOLIS;97;STC;CORTE;2022-08-02;21;21;0;3;N
JUAZEIRO;290;EPS;RECORTE;2022-08-04;55;54;1;5;N
ITABERABA;217;STC;CORTE;2022-08-23;42;41;1;3;N
VITORIA DA CONQUISTA;499;STC;CORTE;2022-08-09;11;11;0;3;N
ILHEUS;186;STC;CORTE;2022-08-04;16;16;0;5;N
ITABUNA;236;STC;CORTE;2022-08-05;20;20;0;6;S
VALENCA;494;STC;CORTE;2022-08-15;11;11;0;2;N
EUNAPOLIS;85;EPS;RECORTE;2022-08-10;3;3;0;4;N
JACOBINA;534;STC;CORTE;2022-08-22;10;10;0;2;N
LUIS EDUARDO MAGALHAES;317;EPS;CORTE;2022-08-15;7;7;0;2;N
CONCEICAO DO COITE;65;EPS;CORTE;2022-08-12;7;7;0;6;N
SANTO AMARO;422;STC;RECORTE;2022-08-23;21;21;0;3;N
PITUBA;357;EPS;RECORTE;2022-08-10;22;20;2;4;N
SANTO AMARO;419;STC;CORTE;2022-08-09;9;7;2;3;N
BRUMADO;48;STC;CORTE;2022-08-15;10;10;0;2;N
ESPLANADA;81;STC;CORTE;2022-08-18;11;11;0;5;N
PORTO SEGURO;369;STC;CORTE;2022-08-11;11;11;0;5;N
BARREIRAS;16;EPS;BAIXA;2022-08-04;8;8;0;5;N
IRECE;202;STC;CORTE;2022-08-16;11;11;0;3;N
POSTO DA MATA;386;EPS;RECORTE;2022-08-10;4;3;1;4;N
ILHEUS;173;EPS;RECORTE;2022-08-24;8;8;0;4;N
JACOBINA;263;EPS;CORTE;2022-08-23;8;7;1;3;N
JUAZEIRO;287;STC;CORTE;2022-08-04;8;8;0;5;N
SENHOR DO BONFIM;448;STC;RECORTE;2022-08-09;11;11;0;3;N
CAMACARI;50;EPS;BAIXA;2022-08-05;12;12;0;6;N
VITORIA DA CONQUISTA;513;EPS;BAIXA;2022-08-23;18;17;1;3;N
PAULO AFONSO;328;EPS;CORTE;2022-08-18;8;6;2;5;N
SANTO ANTONIO DE JESUS;426;STC;CORTE;2022-08-19;13;13;0;6;N
ITABUNA;225;EPS;RECORTE;2022-08-03;6;6;0;4;N
PERIPERI;347;STC;RECORTE;2022-08-22;19;12;7;2;N
BOM JESUS DA LAPA;33;EPS;CORTE;2022-08-11;5;5;0;5;N
JUAZEIRO;290;STC;RECORTE;2022-08-18;16;16;0;5;N
JUAZEIRO;290;STC;RECORTE;2022-08-16;7;1;6;3;S
JACOBINA;534;EPS;CORTE;2022-08-08;7;7;0;2;N
ALAGOINHAS;1;STC;CORTE;2022-08-09;5;4;1;3;N
LUIS EDUARDO MAGALHAES;319;STC;CORTE;2022-08-05;10;0;10;6;N
PORTO SEGURO;371;EPS;DISJUNTOR;2022-08-05;8;0;8;6;N
SANTO ANTONIO DE JESUS;426;EPS;CORTE;2022-08-05;6;0;6;6;N
VALENCA;492;EPS;CORTE;2022-08-25;18;0;18;5;N
ITAPOAN;252;STC;CORTE;2022-08-16;19;17;2;3;N
ESPLANADA;80;EPS;RECORTE;2022-08-17;10;9;1;4;N
ITAPOAN;253;STC;CORTE;2022-08-04;19;18;1;5;N
ALAGOINHAS;1;STC;RECORTE;2022-08-10;5;4;1;4;N
RIBEIRA DO POMBAL;405;EPS;CORTE;2022-08-19;9;9;0;6;N
CANDEIAS;59;EPS;RECORTE;2022-08-18;8;7;1;5;N
SANTA MARIA DA VITORIA;417;STC;CORTE;2022-08-16;11;11;0;3;N
ITABUNA;231;STC;CORTE;2022-08-18;21;19;2;5;N
GRACA;136;EPS;CORTE;2022-08-23;64;56;8;3;N
GRACA;137;EPS;CORTE;2022-08-11;63;56;7;5;N
BOM JESUS DA LAPA;30;STC;CORTE;2022-08-12;11;10;1;6;N
GUANAMBI;142;EPS;DISJUNTOR;2022-08-11;17;16;1;5;N
BRUMADO;45;STC;CORTE;2022-08-02;11;11;0;3;N
AMARGOSA;5;STC;RECORTE;2022-08-23;19;14;5;3;N
JEQUIE;269;EPS;CORTE;2022-08-04;12;11;1;5;N
ITABUNA;235;STC;RECORTE;2022-08-18;7;5;2;5;S
SEABRA;441;EPS;CORTE;2022-08-19;11;11;0;6;N
SANTA MARIA DA VITORIA;417;EPS;CORTE;2022-08-02;10;9;1;3;N
ITABUNA;230;EPS;CORTE;2022-08-16;14;13;1;3;N
SENHOR DO BONFIM;453;STC;CORTE;2022-08-22;13;12;1;2;N
ILHEUS;173;EPS;BAIXA;2022-08-24;2;1;1;4;N
ITABERABA;219;EPS;CORTE;2022-08-11;5;4;1;5;N
FEIRA DE SANTANA NORTE;115;STC;CORTE;2022-08-04;15;15;0;5;N
IRECE;202;STC;RECORTE;2022-08-17;21;19;2;4;N
BOM JESUS DA LAPA;30;STC;CORTE;2022-08-10;8;8;0;4;S
SANTA MARIA DA VITORIA;418;STC;CORTE;2022-08-04;6;6;0;5;N
SERRINHA;458;EPS;CORTE;2022-08-10;16;16;0;4;N
VALENCA;494;STC;RECORTE;2022-08-16;11;11;0;3;N
TEIXEIRA DE FREITAS;477;STC;RECORTE;2022-08-09;5;3;2;3;S
JACOBINA;256;EPS;RECORTE;2022-08-11;7;6;1;5;N
FEIRA DE SANTANA SUL;128;STC;CORTE;2022-08-09;2;2;0;3;N
EUNAPOLIS;90;EPS;CORTE;2022-08-23;12;12;0;3;N
TEIXEIRA DE FREITAS;485;EPS;CORTE;2022-08-23;15;14;1;3;N
BOM JESUS DA LAPA;28;EPS;CORTE;2022-08-22;4;4;0;2;N
EUNAPOLIS;105;EPS;CORTE;2022-08-15;16;16;0;2;N
IRECE;197;STC;CORTE;2022-08-25;5;5;0;5;S
CONCEICAO DO COITE;64;EPS;RECORTE;2022-08-25;6;4;2;5;N
IRECE;203;STC;RECORTE;2022-08-05;17;0;17;6;N
ESPLANADA;78;STC;CORTE;2022-08-05;11;0;11;6;N
CONCEICAO DO COITE;65;STC;RECORTE;2022-08-25;10;5;5;5;S
SANTO AMARO;421;EPS;BAIXA;2022-08-19;16;0;16;6;S
ILHEUS;179;EPS;CORTE;2022-08-25;18;0;18;5;N
SANTO ANTONIO DE JESUS;431;EPS;CORTE;2022-08-19;4;3;1;6;N
SERRINHA;458;EPS;RECORTE;2022-08-11;7;7;0;5;N
VITORIA DA CONQUISTA;508;EPS;RECORTE;2022-08-11;15;14;1;5;N
PITUBA;358;EPS;CORTE;2022-08-22;17;17;0;2;N
SANTA MARIA DA VITORIA;413;STC;CORTE;2022-08-15;11;11;0;2;N
SANTO AMARO;424;STC;CORTE;2022-08-23;21;20;1;3;N
LAURO DE FREITAS;293;STC;CORTE;2022-08-09;16;16;0;3;N
CAMACARI;55;STC;CORTE;2022-08-09;16;15;1;3;N
JUAZEIRO;284;EPS;CORTE;2022-08-03;11;11;0;4;N
SANTO ANTONIO DE JESUS;433;STC;CORTE;2022-08-09;19;19;0;3;N
CONCEICAO DO COITE;76;EPS;RECORTE;2022-08-04;6;3;3;5;N
GRACA;132;EPS;CORTE;2022-08-22;21;21;0;2;N
SANTO ANTONIO DE JESUS;8;EPS;CORTE;2022-08-19;4;4;0;6;N
ITABERABA;216;STC;CORTE;2022-08-12;11;10;1;6;N
ITAPETINGA;243;STC;CORTE;2022-08-09;11;11;0;3;N
JACOBINA;264;STC;CORTE;2022-08-02;14;14;0;3;N
CONCEICAO DO COITE;72;EPS;CORTE;2022-08-02;6;6;0;3;N
CONCEICAO DO COITE;72;STC;CORTE;2022-08-16;11;10;1;3;N
JACOBINA;262;EPS;CORTE;2022-08-12;9;9;0;6;N
BOM JESUS DA LAPA;25;STC;CORTE;2022-08-23;16;16;0;3;N
SANTO AMARO;425;STC;CORTE;2022-08-11;9;9;0;5;N
BOM JESUS DA LAPA;26;STC;CORTE;2022-08-11;11;11;0;5;N
ITABUNA;228;STC;CORTE;2022-08-03;5;5;0;4;S
VITORIA DA CONQUISTA;505;STC;CORTE;2022-08-11;11;11;0;5;N
LUIS EDUARDO MAGALHAES;318;EPS;BAIXA;2022-08-04;17;16;1;5;N
JUAZEIRO;285;STC;CORTE;2022-08-03;10;9;1;4;S
ESPLANADA;80;EPS;BAIXA;2022-08-17;6;5;1;4;N
ITABUNA;230;EPS;RECORTE;2022-08-17;8;7;1;4;N
ITABUNA;226;EPS;CORTE;2022-08-15;14;13;1;2;N
BRUMADO;44;STC;RECORTE;2022-08-15;11;8;3;2;N
GRACA;134;STC;CORTE;2022-08-12;17;15;2;6;N
JACOBINA;261;EPS;CORTE;2022-08-24;8;7;1;4;N
ITAPETINGA;241;EPS;CORTE;2022-08-19;12;10;2;6;N
TEIXEIRA DE FREITAS;472;STC;RECORTE;2022-08-22;17;8;9;2;N
GUANAMBI;142;EPS;CORTE;2022-08-05;7;0;7;6;N
IBOTIRAMA;157;STC;CORTE;2022-08-02;4;4;0;3;N
LUIS EDUARDO MAGALHAES;320;STC;CORTE;2022-08-18;21;20;1;5;N
JUAZEIRO;284;EPS;RECORTE;2022-08-04;11;11;0;5;N
PAULO AFONSO;324;STC;CORTE;2022-08-08;13;12;1;2;N
ITABUNA;231;EPS;BAIXA;2022-08-05;3;2;1;6;N
VITORIA DA CONQUISTA;516;STC;CORTE;2022-08-02;11;10;1;3;N
FEIRA DE SANTANA SUL;125;EPS;CORTE;2022-08-08;24;24;0;2;N
VITORIA DA CONQUISTA;500;STC;CORTE;2022-08-22;11;11;0;2;N
ILHEUS;179;EPS;CORTE;2022-08-02;29;29;0;3;N
GUANAMBI;138;EPS;CORTE;2022-08-04;7;6;1;5;N
IPIAU;188;EPS;CORTE;2022-08-04;11;10;1;5;N
ILHEUS;180;STC;CORTE;2022-08-04;21;20;1;5;N
JACOBINA;257;EPS;CORTE;2022-08-23;8;8;0;3;N
TEIXEIRA DE FREITAS;480;EPS;DISJUNTOR;2022-08-17;12;12;0;4;N
GRACA;130;STC;CORTE;2022-08-11;17;17;0;5;N
IBOTIRAMA;160;STC;RECORTE;2022-08-16;5;4;1;3;N
BARREIRAS;16;STC;CORTE;2022-08-19;21;20;1;6;N
ALAGOINHAS;2;STC;CORTE;2022-08-22;17;16;1;2;N
SERRINHA;464;EPS;CORTE;2022-08-12;9;9;0;6;N
JACOBINA;261;EPS;RECORTE;2022-08-25;8;3;5;5;N
ILHEUS;177;EPS;CORTE;2022-08-24;5;4;1;4;S
BOM JESUS DA LAPA;29;EPS;BAIXA;2022-08-11;6;6;0;5;N
LUIS EDUARDO MAGALHAES;319;EPS;CORTE;2022-08-16;7;7;0;3;N
ITABUNA;230;EPS;BAIXA;2022-08-17;8;6;2;4;N
IRECE;197;STC;CORTE;2022-08-04;11;11;0;5;N
ITAPOAN;250;EPS;BAIXA;2022-08-25;14;10;4;5;S
IRECE;200;STC;RECORTE;2022-08-16;7;6;1;3;S
JACOBINA;263;STC;RECORTE;2022-08-15;16;16;0;2;N
JACOBINA;258;STC;CORTE;2022-08-25;16;15;1;5;N
SERRINHA;463;EPS;CORTE;2022-08-24;6;3;3;4;N
REMANSO;393;EPS;CORTE;2022-08-18;20;20;0;5;N
IBOTIRAMA;155;EPS;CORTE;2022-08-12;14;14;0;6;N
CONCEICAO DO COITE;76;EPS;BAIXA;2022-08-04;5;2;3;5;N
ITABERABA;215;STC;DISJUNTOR;2022-08-05;20;20;0;6;S
SENHOR DO BONFIM;451;EPS;CORTE;2022-08-09;6;6;0;3;N
LIVRAMENTO DE NOSSA SENHORA;302;STC;RECORTE;2022-08-24;5;2;3;4;N
VALENCA;486;EPS;CORTE;2022-08-25;10;0;10;5;N
PERIPERI;347;STC;CORTE;2022-08-23;32;31;1;3;N
PITUBA;357;EPS;CORTE;2022-08-11;20;18;2;5;N
FEIRA DE SANTANA SUL;122;STC;CORTE;2022-08-09;32;31;1;3;N
SENHOR DO BONFIM;447;STC;CORTE;2022-08-22;13;10;3;2;N
VITORIA DA CONQUISTA;509;EPS;CORTE;2022-08-23;15;14;1;3;N
REMANSO;390;STC;CORTE;2022-08-19;11;10;1;6;N
PERIPERI;347;EPS;CORTE;2022-08-09;32;28;4;3;N
EUNAPOLIS;85;EPS;CORTE;2022-08-11;12;11;1;5;N
PORTO SEGURO;374;STC;CORTE;2022-08-02;21;19;2;3;N
JUAZEIRO;289;EPS;CORTE;2022-08-17;13;11;2;4;N
JACOBINA;255;STC;CORTE;2022-08-12;17;17;0;6;N
PIRAJA;352;STC;CORTE;2022-08-15;17;17;0;2;N
PERIPERI;348;STC;CORTE;2022-08-11;16;16;0;5;N
CONCEICAO DO COITE;68;STC;RECORTE;2022-08-16;11;8;3;3;N
IBOTIRAMA;154;EPS;RECORTE;2022-08-25;8;7;1;5;N
AMARGOSA;11;EPS;DISJUNTOR;2022-08-19;3;3;0;6;N
SENHOR DO BONFIM;447;EPS;CORTE;2022-08-08;8;8;0;2;N
LUIS EDUARDO MAGALHAES;323;EPS;BAIXA;2022-08-18;20;16;4;5;N
ILHEUS;179;EPS;RECORTE;2022-08-03;10;7;3;4;N
LAURO DE FREITAS;298;EPS;CORTE;2022-08-09;18;15;3;3;N
EUNAPOLIS;88;EPS;RECORTE;2022-08-25;3;2;1;5;N
SERRINHA;463;EPS;RECORTE;2022-08-25;6;6;0;5;N
CAMACARI;51;STC;RECORTE;2022-08-09;16;15;1;3;N
PITUBA;359;EPS;BAIXA;2022-08-11;54;42;12;5;N
JUAZEIRO;284;EPS;BAIXA;2022-08-04;4;3;1;5;N
VITORIA DA CONQUISTA;503;EPS;BAIXA;2022-08-22;12;6;6;2;N
ITAPETINGA;248;STC;CORTE;2022-08-23;9;9;0;3;N
SENHOR DO BONFIM;451;EPS;RECORTE;2022-08-10;6;6;0;4;N
BOM JESUS DA LAPA;31;STC;CORTE;2022-08-25;16;16;0;5;N
IBOTIRAMA;166;EPS;CORTE;2022-08-03;4;4;0;4;N
SERRINHA;459;EPS;CORTE;2022-08-23;7;7;0;3;N
JUAZEIRO;290;EPS;CORTE;2022-08-05;36;0;36;6;N
ILHEUS;173;EPS;CORTE;2022-08-25;27;0;27;5;N
PIRAJA;350;EPS;CORTE;2022-08-25;12;0;12;5;N
ALAGOINHAS;1;STC;CORTE;2022-08-11;23;23;0;5;N
VALENCA;497;EPS;RECORTE;2022-08-17;8;8;0;4;N
PERIPERI;348;STC;RECORTE;2022-08-12;19;11;8;6;N
ITAPOAN;250;EPS;BAIXA;2022-08-04;39;27;12;5;N
JUAZEIRO;289;EPS;RECORTE;2022-08-18;8;6;2;5;N
JUAZEIRO;285;EPS;CORTE;2022-08-16;15;14;1;3;N
PAULO AFONSO;329;STC;CORTE;2022-08-22;16;16;0;2;N
AMARGOSA;11;STC;RECORTE;2022-08-02;20;18;2;3;N
JUAZEIRO;286;STC;CORTE;2022-08-18;9;9;0;5;N
AMARGOSA;6;STC;CORTE;2022-08-12;18;18;0;6;N
ITAPETINGA;237;STC;CORTE;2022-08-09;9;9;0;3;N
POSTO DA MATA;388;STC;RECORTE;2022-08-02;11;10;1;3;N
VITORIA DA CONQUISTA;521;STC;CORTE;2022-08-16;11;11;0;3;N
SENHOR DO BONFIM;447;STC;RECORTE;2022-08-23;17;17;0;3;N
VALENCA;493;EPS;CORTE;2022-08-15;7;7;0;2;N
VITORIA DA CONQUISTA;499;STC;CORTE;2022-08-11;11;11;0;5;N
IRECE;202;STC;CORTE;2022-08-18;19;18;1;5;N
JACOBINA;534;EPS;CORTE;2022-08-10;9;8;1;4;N
PAULO AFONSO;333;EPS;RECORTE;2022-08-10;6;5;1;4;N
PITUBA;356;EPS;RECORTE;2022-08-24;13;9;4;4;N
POSTO DA MATA;385;EPS;RECORTE;2022-08-24;5;3;2;4;N
CONCEICAO DO COITE;66;EPS;CORTE;2022-08-02;5;5;0;3;N
ESPLANADA;80;EPS;CORTE;2022-08-18;11;11;0;5;N
PIRAJA;354;EPS;BAIXA;2022-08-25;1;1;0;5;S
JUAZEIRO;290;STC;RECORTE;2022-08-18;8;5;3;5;S
FEIRA DE SANTANA SUL;122;STC;RECORTE;2022-08-10;1;1;0;4;N
PIRAJA;353;STC;RECORTE;2022-08-04;17;13;4;5;N
SANTO AMARO;422;STC;RECORTE;2022-08-23;12;12;0;3;S
IRECE;201;EPS;CORTE;2022-08-16;9;9;0;3;N
ITABERABA;217;STC;CORTE;2022-08-25;42;42;0;5;N
TEIXEIRA DE FREITAS;475;EPS;CORTE;2022-08-22;10;10;0;2;N
BARREIRAS;21;EPS;CORTE;2022-08-19;7;7;0;6;N
IRECE;207;STC;RECORTE;2022-08-08;16;16;0;2;N
BRUMADO;49;STC;CORTE;2022-08-05;11;0;11;6;N
VALENCA;495;STC;CORTE;2022-08-05;17;0;17;6;N
SANTO AMARO;421;EPS;DISJUNTOR;2022-08-05;6;0;6;6;N
LUIS EDUARDO MAGALHAES;318;EPS;CORTE;2022-08-05;8;0;8;6;N
ITAPOAN;251;EPS;CORTE;2022-08-16;19;15;4;3;N
ITAPOAN;252;STC;CORTE;2022-08-18;105;102;3;5;N
SENHOR DO BONFIM;454;STC;CORTE;2022-08-12;13;12;1;6;N
IRECE;211;EPS;CORTE;2022-08-19;16;15;1;6;N
IPIAU;526;STC;CORTE;2022-08-09;13;13;0;3;N
IRECE;202;STC;RECORTE;2022-08-17;10;3;7;4;S
RIBEIRA DO POMBAL;410;EPS;RECORTE;2022-08-11;9;9;0;5;N
JACOBINA;534;EPS;RECORTE;2022-08-11;7;6;1;5;N
ILHEUS;180;EPS;CORTE;2022-08-15;23;21;2;2;N
ITAPETINGA;246;STC;CORTE;2022-08-22;18;15;3;2;S
SENHOR DO BONFIM;453;STC;CORTE;2022-08-22;11;11;0;2;S
VALENCA;491;STC;CORTE;2022-08-04;17;17;0;5;N
ITAPETINGA;245;EPS;CORTE;2022-08-22;10;10;0;2;N
ESPLANADA;77;STC;CORTE;2022-08-19;11;11;0;6;N
SANTA MARIA DA VITORIA;417;STC;CORTE;2022-08-18;16;15;1;5;N
BOM JESUS DA LAPA;31;STC;CORTE;2022-08-02;11;11;0;3;N
FEIRA DE SANTANA SUL;128;STC;CORTE;2022-08-11;17;17;0;5;N
SEABRA;443;STC;CORTE;2022-08-11;11;11;0;5;N
IBOTIRAMA;171;EPS;CORTE;2022-08-17;7;7;0;4;N
PORTO SEGURO;363;EPS;CORTE;2022-08-22;13;13;0;2;N
CONCEICAO DO COITE;64;EPS;RECORTE;2022-08-25;15;12;3;5;S
BRUMADO;44;EPS;CORTE;2022-08-02;6;5;1;3;N
VITORIA DA CONQUISTA;509;EPS;BAIXA;2022-08-24;20;1;19;4;N
BOM JESUS DA LAPA;29;EPS;CORTE;2022-08-12;5;5;0;6;N
LAURO DE FREITAS;294;STC;RECORTE;2022-08-23;16;15;1;3;N
PAULO AFONSO;329;STC;RECORTE;2022-08-23;5;2;3;3;N
TEIXEIRA DE FREITAS;477;STC;RECORTE;2022-08-11;18;18;0;5;S
PAULO AFONSO;332;EPS;BAIXA;2022-08-22;6;6;0;2;N
VALENCA;498;EPS;BAIXA;2022-08-05;18;16;2;6;N
FEIRA DE SANTANA NORTE;116;EPS;BAIXA;2022-08-04;8;4;4;5;N
SANTO AMARO;422;EPS;BAIXA;2022-08-11;18;16;2;5;N
EUNAPOLIS;105;EPS;CORTE;2022-08-17;6;6;0;4;N
FEIRA DE SANTANA SUL;127;EPS;CORTE;2022-08-09;19;17;2;3;N
ALAGOINHAS;1;STC;RECORTE;2022-08-12;9;7;2;6;N
FEIRA DE SANTANA SUL;127;STC;CORTE;2022-08-23;1;1;0;3;N
SERRINHA;456;STC;RECORTE;2022-08-25;11;9;2;5;N
ITAPETINGA;242;STC;CORTE;2022-08-23;9;7;2;3;N
ITAPOAN;251;EPS;RECORTE;2022-08-17;19;19;0;4;N
SANTO ANTONIO DE JESUS;432;STC;CORTE;2022-08-23;13;12;1;3;N
VITORIA DA CONQUISTA;519;EPS;CORTE;2022-08-03;22;21;1;4;N
ITABERABA;217;STC;CORTE;2022-08-02;11;10;1;3;N
ILHEUS;178;EPS;DISJUNTOR;2022-08-22;35;34;1;2;N
TEIXEIRA DE FREITAS;482;EPS;CORTE;2022-08-12;11;11;0;6;N
VITORIA DA CONQUISTA;503;EPS;CORTE;2022-08-23;15;14;1;3;N
BRUMADO;44;EPS;RECORTE;2022-08-03;4;4;0;4;N
SENHOR DO BONFIM;449;STC;CORTE;2022-08-23;10;9;1;3;N
GRACA;133;EPS;CORTE;2022-08-12;21;20;1;6;N
FEIRA DE SANTANA NORTE;109;EPS;CORTE;2022-08-15;42;37;5;2;N
IRECE;207;EPS;CORTE;2022-08-18;32;29;3;5;N
SANTO ANTONIO DE JESUS;435;STC;DISJUNTOR;2022-08-17;15;15;0;4;S
REMANSO;389;STC;RECORTE;2022-08-09;17;12;5;3;N
JACOBINA;263;EPS;CORTE;2022-08-02;9;9;0;3;N
LUIS EDUARDO MAGALHAES;323;EPS;CORTE;2022-08-19;7;7;0;6;N
PITUBA;359;EPS;CORTE;2022-08-12;19;19;0;6;N
PORTO SEGURO;377;EPS;DISJUNTOR;2022-08-09;15;15;0;3;N
ILHEUS;173;EPS;RECORTE;2022-08-03;10;10;0;4;N
FEIRA DE SANTANA SUL;123;STC;CORTE;2022-08-22;1;1;0;2;N
LIVRAMENTO DE NOSSA SENHORA;302;EPS;CORTE;2022-08-11;5;4;1;5;N
SANTO ANTONIO DE JESUS;9;EPS;CORTE;2022-08-09;10;9;1;3;N
SANTO AMARO;424;EPS;CORTE;2022-08-11;22;13;9;5;N
SEABRA;442;STC;RECORTE;2022-08-24;14;13;1;4;N
SANTO AMARO;424;STC;CORTE;2022-08-25;21;21;0;5;N
VITORIA DA CONQUISTA;504;STC;CORTE;2022-08-25;11;11;0;5;N
BOM JESUS DA LAPA;24;EPS;CORTE;2022-08-23;4;4;0;3;N
TEIXEIRA DE FREITAS;481;EPS;CORTE;2022-08-24;9;8;1;4;N
SANTO ANTONIO DE JESUS;432;EPS;CORTE;2022-08-09;5;5;0;3;N
JUAZEIRO;284;EPS;CORTE;2022-08-05;18;0;18;6;N
ITABUNA;227;EPS;CORTE;2022-08-05;17;0;17;6;N
FEIRA DE SANTANA SUL;127;STC;RECORTE;2022-08-24;1;1;0;4;N
LUIS EDUARDO MAGALHAES;314;STC;RECORTE;2022-08-17;1;0;1;4;S
TEIXEIRA DE FREITAS;480;EPS;DISJUNTOR;2022-08-19;20;20;0;6;N
ITAPETINGA;238;STC;CORTE;2022-08-22;9;9;0;2;N
FEIRA DE SANTANA NORTE;107;STC;CORTE;2022-08-02;4;4;0;3;S
VITORIA DA CONQUISTA;519;EPS;RECORTE;2022-08-04;16;14;2;5;N
JEQUIE;275;EPS;CORTE;2022-08-08;21;20;1;2;N
ALAGOINHAS;1;EPS;CORTE;2022-08-22;30;28;2;2;N
ALAGOINHAS;3;STC;CORTE;2022-08-12;24;24;0;6;N
RIBEIRA DO POMBAL;399;STC;CORTE;2022-08-09;11;11;0;3;N
FEIRA DE SANTANA NORTE;106;EPS;CORTE;2022-08-02;9;9;0;3;N
SANTO ANTONIO DE JESUS;432;EPS;RECORTE;2022-08-10;6;6;0;4;N
CONCEICAO DO COITE;68;EPS;CORTE;2022-08-03;6;6;0;4;N
IPIAU;531;EPS;CORTE;2022-08-09;8;8;0;3;N
REMANSO;394;STC;CORTE;2022-08-22;15;15;0;2;N
FEIRA DE SANTANA NORTE;107;STC;CORTE;2022-08-04;11;10;1;5;N
IPIAU;189;STC;CORTE;2022-08-08;16;16;0;2;N
BARREIRAS;17;STC;CORTE;2022-08-09;14;13;1;3;N
IPIAU;532;STC;CORTE;2022-08-11;13;13;0;5;N
CAMACARI;50;EPS;CORTE;2022-08-08;25;24;1;2;N
ITAPOAN;252;EPS;BAIXA;2022-08-05;8;7;1;6;N
ITAPOAN;251;EPS;BAIXA;2022-08-17;19;18;1;4;N
PAULO AFONSO;346;STC;CORTE;2022-08-15;11;11;0;2;N
GRACA;129;EPS;CORTE;2022-08-11;21;16;5;5;N
TEIXEIRA DE FREITAS;481;EPS;RECORTE;2022-08-25;25;15;10;5;N
LUIS EDUARDO MAGALHAES;319;EPS;CORTE;2022-08-18;7;7;0;5;N
SENHOR DO BONFIM;451;EPS;CORTE;2022-08-11;6;6;0;5;N
SANTO AMARO;422;EPS;DISJUNTOR;2022-08-18;12;12;0;5;N
TEIXEIRA DE FREITAS;471;EPS;BAIXA;2022-08-22;15;15;0;2;N
PITUBA;358;EPS;RECORTE;2022-08-25;14;14;0;5;N
ITABUNA;227;STC;RECORTE;2022-08-18;18;10;8;5;S
IBOTIRAMA;156;EPS;CORTE;2022-08-02;4;4;0;3;N
JEQUIE;266;STC;RECORTE;2022-08-08;11;11;0;2;N
FEIRA DE SANTANA NORTE;106;STC;CORTE;2022-08-16;4;4;0;3;N
IRECE;195;EPS;CORTE;2022-08-16;9;6;3;3;N
EUNAPOLIS;90;EPS;CORTE;2022-08-02;12;12;0;3;N
ILHEUS;179;EPS;CORTE;2022-08-04;12;0;12;5;N
ITABERABA;215;STC;RECORTE;2022-08-25;7;5;2;5;S
CONCEICAO DO COITE;65;STC;CORTE;2022-08-04;11;10;1;5;N
CONCEICAO DO COITE;64;STC;CORTE;2022-08-16;11;10;1;3;N
VITORIA DA CONQUISTA;525;STC;CORTE;2022-08-19;10;10;0;6;N
BRUMADO;38;EPS;CORTE;2022-08-02;6;6;0;3;N
BOM JESUS DA LAPA;32;STC;CORTE;2022-08-15;9;8;1;2;N
PIRAJA;351;EPS;CORTE;2022-08-15;16;15;1;2;N
REMANSO;391;STC;CORTE;2022-08-09;19;16;3;3;N
LIVRAMENTO DE NOSSA SENHORA;309;STC;CORTE;2022-08-15;9;9;0;2;N
CANDEIAS;59;STC;CORTE;2022-08-09;13;12;1;3;N
SERRINHA;461;STC;CORTE;2022-08-15;11;11;0;2;N
REMANSO;389;EPS;CORTE;2022-08-19;19;19;0;6;N
IBOTIRAMA;166;STC;CORTE;2022-08-19;6;6;0;6;N
REMANSO;390;STC;CORTE;2022-08-19;5;5;0;6;S
CAMACARI;50;STC;RECORTE;2022-08-23;32;25;7;3;N
ILHEUS;178;EPS;RECORTE;2022-08-17;9;9;0;4;N
SENHOR DO BONFIM;450;EPS;RECORTE;2022-08-24;11;11;0;4;N
FEIRA DE SANTANA NORTE;115;EPS;CORTE;2022-08-17;55;52;3;4;N
PIRAJA;354;EPS;DISJUNTOR;2022-08-11;18;18;0;5;N
FEIRA DE SANTANA SUL;122;STC;CORTE;2022-08-11;1;1;0;5;N
PERIPERI;347;EPS;CORTE;2022-08-11;30;30;0;5;N
SANTA MARIA DA VITORIA;535;EPS;CORTE;2022-08-11;8;8;0;5;N
FEIRA DE SANTANA SUL;125;EPS;RECORTE;2022-08-11;20;16;4;5;N
IPIAU;189;STC;RECORTE;2022-08-09;16;6;10;3;N
FEIRA DE SANTANA NORTE;110;EPS;BAIXA;2022-08-04;8;7;1;5;N
SANTA MARIA DA VITORIA;413;EPS;BAIXA;2022-08-04;8;8;0;5;N
GUANAMBI;148;EPS;CORTE;2022-08-09;6;6;0;3;N
BARREIRAS;16;STC;RECORTE;2022-08-22;21;19;2;2;N
EUNAPOLIS;88;EPS;DISJUNTOR;2022-08-09;7;7;0;3;N
CAMACARI;51;STC;RECORTE;2022-08-11;16;15;1;5;N
PERIPERI;347;STC;CORTE;2022-08-25;16;13;3;5;N
PAULO AFONSO;332;EPS;CORTE;2022-08-23;6;6;0;3;N
FEIRA DE SANTANA SUL;121;EPS;CORTE;2022-08-09;19;18;1;3;N
ITABUNA;234;STC;CORTE;2022-08-09;16;15;1;3;N
FEIRA DE SANTANA NORTE;107;STC;RECORTE;2022-08-05;15;0;15;6;N
IRECE;193;STC;CORTE;2022-08-05;11;0;11;6;N
FEIRA DE SANTANA NORTE;116;EPS;CORTE;2022-08-05;18;0;18;6;N
POSTO DA MATA;385;EPS;CORTE;2022-08-25;16;0;16;5;N
BOM JESUS DA LAPA;30;EPS;CORTE;2022-08-25;4;0;4;5;N
LAURO DE FREITAS;295;STC;CORTE;2022-08-12;16;16;0;6;N
SERRINHA;458;STC;CORTE;2022-08-02;11;11;0;3;N
JEQUIE;282;STC;CORTE;2022-08-12;5;5;0;6;N
PAULO AFONSO;330;STC;CORTE;2022-08-12;11;11;0;6;N
RIBEIRA DO POMBAL;404;STC;CORTE;2022-08-23;11;11;0;3;N
CONCEICAO DO COITE;74;STC;CORTE;2022-08-17;2;2;0;4;S
LAURO DE FREITAS;293;EPS;CORTE;2022-08-22;8;8;0;2;N
ITABERABA;218;STC;CORTE;2022-08-15;11;11;0;2;N
AMARGOSA;5;EPS;CORTE;2022-08-12;24;23;1;6;N
POSTO DA MATA;382;EPS;CORTE;2022-08-12;4;3;1;6;N
AMARGOSA;7;STC;CORTE;2022-08-02;20;20;0;3;N
ITABERABA;222;STC;RECORTE;2022-08-17;18;14;4;4;N
PITUBA;356;EPS;DISJUNTOR;2022-08-08;15;13;2;2;N
GRACA;136;STC;CORTE;2022-08-15;17;16;1;2;N
POSTO DA MATA;387;STC;RECORTE;2022-08-16;18;17;1;3;N
EUNAPOLIS;99;EPS;RECORTE;2022-08-18;3;3;0;5;N
VITORIA DA CONQUISTA;520;EPS;CORTE;2022-08-16;15;13;2;3;N
FEIRA DE SANTANA NORTE;112;STC;CORTE;2022-08-18;21;19;2;5;N
CAMACARI;55;EPS;CORTE;2022-08-22;21;20;1;2;N
JACOBINA;264;EPS;CORTE;2022-08-15;9;8;1;2;N
PAULO AFONSO;345;STC;CORTE;2022-08-04;11;11;0;5;N
SERRINHA;456;STC;CORTE;2022-08-24;5;5;0;4;S
PORTO SEGURO;373;EPS;RECORTE;2022-08-03;18;13;5;4;N
CONCEICAO DO COITE;68;EPS;BAIXA;2022-08-04;5;5;0;5;N
BRUMADO;49;EPS;BAIXA;2022-08-17;3;3;0;4;N
IRECE;193;STC;RECORTE;2022-08-04;18;16;2;5;S
PERIPERI;347;STC;RECORTE;2022-08-24;26;14;12;4;S
REMANSO;391;STC;RECORTE;2022-08-10;21;21;0;4;N
IBOTIRAMA;154;EPS;BAIXA;2022-08-25;14;14;0;5;S
BARREIRAS;22;EPS;CORTE;2022-08-09;8;8;0;3;N
JUAZEIRO;290;STC;RECORTE;2022-08-22;16;12;4;2;N
SERRINHA;456;EPS;CORTE;2022-08-12;9;9;0;6;N
EUNAPOLIS;101;STC;RECORTE;2022-08-08;12;12;0;2;N
PORTO SEGURO;371;EPS;DISJUNTOR;2022-08-09;8;7;1;3;N
PIRAJA;352;STC;RECORTE;2022-08-18;17;14;3;5;N
SERRINHA;455;EPS;CORTE;2022-08-24;6;6;0;4;N
PAULO AFONSO;328;EPS;CORTE;2022-08-22;7;7;0;2;N
JACOBINA;534;EPS;CORTE;2022-08-12;9;9;0;6;N
SANTO ANTONIO DE JESUS;426;EPS;CORTE;2022-08-09;5;5;0;3;N
VALENCA;494;EPS;CORTE;2022-08-05;8;0;8;6;N
ITABERABA;216;EPS;CORTE;2022-08-25;3;0;3;5;N
GRACA;134;EPS;CORTE;2022-08-25;21;0;21;5;N
JACOBINA;261;STC;CORTE;2022-08-16;16;15;1;3;N
SENHOR DO BONFIM;453;EPS;CORTE;2022-08-12;6;5;1;6;N
SANTO ANTONIO DE JESUS;426;EPS;RECORTE;2022-08-10;6;6;0;4;N
ALAGOINHAS;2;STC;RECORTE;2022-08-02;18;12;6;3;N
VITORIA DA CONQUISTA;500;STC;RECORTE;2022-08-02;17;13;4;3;N
SEABRA;441;EPS;CORTE;2022-08-23;10;10;0;3;N
BARREIRAS;18;STC;CORTE;2022-08-22;21;21;0;2;N
VALENCA;489;EPS;CORTE;2022-08-16;37;37;0;3;N
SANTA MARIA DA VITORIA;418;STC;CORTE;2022-08-08;7;5;2;2;N
CAMACARI;52;STC;CORTE;2022-08-23;32;31;1;3;N
GUANAMBI;141;STC;CORTE;2022-08-09;11;11;0;3;N
VALENCA;490;EPS;CORTE;2022-08-04;16;16;0;5;N
VITORIA DA CONQUISTA;509;EPS;CORTE;2022-08-02;15;15;0;3;N
GUANAMBI;142;EPS;DISJUNTOR;2022-08-15;11;11;0;2;N
IRECE;198;STC;CORTE;2022-08-17;10;10;0;4;S
ESPLANADA;81;STC;RECORTE;2022-08-23;21;20;1;3;N
IRECE;198;STC;CORTE;2022-08-19;20;20;0;6;N
PAULO AFONSO;326;STC;CORTE;2022-08-11;11;11;0;5;N
JEQUIE;278;STC;CORTE;2022-08-11;11;11;0;5;N
JEQUIE;281;STC;RECORTE;2022-08-23;5;4;1;3;S
GUANAMBI;139;EPS;CORTE;2022-08-19;6;6;0;6;N
VALENCA;495;STC;RECORTE;2022-08-08;17;16;1;2;N
LAURO DE FREITAS;294;EPS;RECORTE;2022-08-11;39;36;3;5;N
BOM JESUS DA LAPA;30;EPS;CORTE;2022-08-02;7;6;1;3;N
IPIAU;189;EPS;CORTE;2022-08-19;8;6;2;6;N
IRECE;192;EPS;BAIXA;2022-08-04;7;7;0;5;N
LUIS EDUARDO MAGALHAES;313;EPS;CORTE;2022-08-18;6;6;0;5;N
ESPLANADA;78;STC;CORTE;2022-08-09;11;11;0;3;N
ALAGOINHAS;1;STC;RECORTE;2022-08-12;15;13;2;6;S
ITAPOAN;253;STC;CORTE;2022-08-08;11;11;0;2;N
FEIRA DE SANTANA SUL;127;STC;CORTE;2022-08-25;1;1;0;5;N
EUNAPOLIS;105;EPS;CORTE;2022-08-19;15;15;0;6;N
SEABRA;442;EPS;CORTE;2022-08-11;5;5;0;5;N
SERRINHA;468;STC;CORTE;2022-08-05;11;0;11;6;N
LAURO DE FREITAS;293;EPS;DISJUNTOR;2022-08-05;15;0;15;6;N
IRECE;198;EPS;CORTE;2022-08-05;12;0;12;6;N
PAULO AFONSO;338;EPS;CORTE;2022-08-25;8;0;8;5;N
AMARGOSA;12;STC;CORTE;2022-08-16;16;16;0;3;N
SEABRA;444;STC;RECORTE;2022-08-02;13;8;5;3;N
TEIXEIRA DE FREITAS;469;STC;CORTE;2022-08-12;17;17;0;6;N
FEIRA DE SANTANA SUL;122;EPS;CORTE;2022-08-22;18;18;0;2;N
IRECE;208;STC;CORTE;2022-08-22;19;18;1;2;N
FEIRA DE SANTANA NORTE;109;EPS;CORTE;2022-08-17;60;59;1;4;N
PIRAJA;354;STC;CORTE;2022-08-18;17;17;0;5;N
PAULO AFONSO;401;STC;CORTE;2022-08-19;11;11;0;6;N
VALENCA;489;EPS;RECORTE;2022-08-17;7;6;1;4;N
ITAPOAN;251;EPS;RECORTE;2022-08-19;20;19;1;6;N
SANTO ANTONIO DE JESUS;432;EPS;CORTE;2022-08-11;5;4;1;5;N
SANTO ANTONIO DE JESUS;9;EPS;CORTE;2022-08-11;10;9;1;5;N
SANTO AMARO;425;STC;CORTE;2022-08-15;9;8;1;2;N
JUAZEIRO;292;STC;CORTE;2022-08-22;9;9;0;2;N
GRACA;134;EPS;CORTE;2022-08-02;25;21;4;3;N
FEIRA DE SANTANA NORTE;111;EPS;BAIXA;2022-08-17;7;7;0;4;N
CONCEICAO DO COITE;62;EPS;RECORTE;2022-08-04;6;6;0;5;N
SENHOR DO BONFIM;454;STC;RECORTE;2022-08-15;17;16;1;2;N
SERRINHA;467;STC;RECORTE;2022-08-18;11;9;2;5;N
SENHOR DO BONFIM;449;STC;CORTE;2022-08-25;9;8;1;5;N
SANTO ANTONIO DE JESUS;8;EPS;CORTE;2022-08-23;4;3;1;3;N
SANTO ANTONIO DE JESUS;431;EPS;CORTE;2022-08-23;4;3;1;3;N
LAURO DE FREITAS;294;EPS;BAIXA;2022-08-11;5;3;2;5;N
BRUMADO;41;STC;CORTE;2022-08-05;11;0;11;6;N
IBOTIRAMA;160;EPS;CORTE;2022-08-05;6;0;6;6;N
FEIRA DE SANTANA NORTE;106;STC;CORTE;2022-08-18;19;19;0;5;N
IPIAU;188;EPS;CORTE;2022-08-08;11;11;0;2;N
CAMACARI;50;EPS;CORTE;2022-08-10;59;55;4;4;N
CONCEICAO DO COITE;68;STC;CORTE;2022-08-17;10;10;0;4;S
BOM JESUS DA LAPA;23;STC;CORTE;2022-08-02;11;10;1;3;N
REMANSO;393;EPS;CORTE;2022-08-22;23;22;1;2;N
BARREIRAS;16;EPS;CORTE;2022-08-09;40;39;1;3;N
GRACA;134;EPS;RECORTE;2022-08-03;19;18;1;4;N
PAULO AFONSO;345;EPS;CORTE;2022-08-15;8;8;0;2;N
ITABERABA;216;STC;RECORTE;2022-08-17;21;19;2;4;N
SERRINHA;456;STC;RECORTE;2022-08-02;4;3;1;3;S
PITUBA;356;STC;CORTE;2022-08-15;38;37;1;2;N
ALAGOINHAS;2;EPS;CORTE;2022-08-12;30;30;0;6;N
CAMACARI;51;STC;CORTE;2022-08-12;16;15;1;6;N
RIBEIRA DO POMBAL;399;STC;CORTE;2022-08-11;11;11;0;5;N
LUIS EDUARDO MAGALHAES;320;EPS;CORTE;2022-08-08;10;8;2;2;N
SANTO ANTONIO DE JESUS;429;STC;CORTE;2022-08-12;13;13;0;6;N
ITAPETINGA;239;STC;CORTE;2022-08-12;9;9;0;6;N
LUIS EDUARDO MAGALHAES;320;STC;CORTE;2022-08-22;9;9;0;2;N
BRUMADO;36;STC;CORTE;2022-08-16;10;10;0;3;N
JACOBINA;259;EPS;CORTE;2022-08-03;6;6;0;4;N
IBOTIRAMA;156;STC;CORTE;2022-08-18;14;14;0;5;N
VITORIA DA CONQUISTA;518;EPS;RECORTE;2022-08-18;16;15;1;5;N
IBOTIRAMA;159;EPS;RECORTE;2022-08-18;5;5;0;5;N
SANTO AMARO;423;EPS;DISJUNTOR;2022-08-08;9;9;0;2;N
SANTO ANTONIO DE JESUS;431;EPS;RECORTE;2022-08-24;8;8;0;4;N
LIVRAMENTO DE NOSSA SENHORA;312;EPS;CORTE;2022-08-16;6;6;0;3;N
SANTO ANTONIO DE JESUS;427;EPS;CORTE;2022-08-22;4;4;0;2;N
IBOTIRAMA;155;EPS;CORTE;2022-08-16;14;12;2;3;N
JACOBINA;258;EPS;CORTE;2022-08-15;9;8;1;2;N
SANTA MARIA DA VITORIA;414;STC;RECORTE;2022-08-08;11;10;1;2;N
VITORIA DA CONQUISTA;519;STC;RECORTE;2022-08-18;5;1;4;5;S
IPIAU;531;EPS;CORTE;2022-08-11;8;8;0;5;N
PITUBA;358;EPS;DISJUNTOR;2022-08-09;12;12;0;3;N
CONCEICAO DO COITE;62;EPS;BAIXA;2022-08-04;5;3;2;5;N
ITABERABA;217;STC;RECORTE;2022-08-05;11;0;11;6;N
JACOBINA;260;STC;CORTE;2022-08-05;8;0;8;6;N
CONCEICAO DO COITE;68;EPS;CORTE;2022-08-05;9;0;9;6;N
ITABUNA;172;EPS;CORTE;2022-08-05;17;0;17;6;N
ITAPETINGA;249;STC;CORTE;2022-08-15;9;9;0;2;N
REMANSO;390;EPS;CORTE;2022-08-09;9;9;0;3;N
CANDEIAS;58;STC;CORTE;2022-08-23;16;16;0;3;N
ITABUNA;234;STC;CORTE;2022-08-11;16;16;0;5;N
ALAGOINHAS;3;STC;RECORTE;2022-08-15;9;8;1;2;N
SENHOR DO BONFIM;448;STC;CORTE;2022-08-12;15;15;0;6;S
IRECE;192;STC;CORTE;2022-08-17;13;13;0;4;S
LIVRAMENTO DE NOSSA SENHORA;312;EPS;RECORTE;2022-08-17;4;4;0;4;N
PERIPERI;348;STC;CORTE;2022-08-15;16;16;0;2;N
JACOBINA;255;STC;CORTE;2022-08-16;16;16;0;3;N
JACOBINA;256;STC;CORTE;2022-08-04;16;16;0;5;N
POSTO DA MATA;386;EPS;CORTE;2022-08-15;7;7;0;2;N
CONCEICAO DO COITE;63;EPS;CORTE;2022-08-16;6;5;1;3;N
EUNAPOLIS;85;EPS;CORTE;2022-08-15;8;8;0;2;N
LIVRAMENTO DE NOSSA SENHORA;310;STC;CORTE;2022-08-03;3;3;0;4;S
JACOBINA;259;EPS;RECORTE;2022-08-04;8;7;1;5;N
CONCEICAO DO COITE;67;EPS;RECORTE;2022-08-18;6;6;0;5;N
JACOBINA;255;EPS;CORTE;2022-08-02;9;9;0;3;N
JUAZEIRO;290;EPS;CORTE;2022-08-09;30;27;3;3;N
BARREIRAS;16;EPS;RECORTE;2022-08-10;8;8;0;4;N
JEQUIE;271;EPS;CORTE;2022-08-09;18;17;1;3;N
RIBEIRA DO POMBAL;408;EPS;CORTE;2022-08-12;10;10;0;6;N
ITABUNA;233;STC;CORTE;2022-08-23;18;17;1;3;N
CANDEIAS;58;EPS;CORTE;2022-08-09;38;37;1;3;N
CAMACARI;50;EPS;RECORTE;2022-08-11;48;47;1;5;N
GRACA;132;EPS;BAIXA;2022-08-25;18;17;1;5;S
LUIS EDUARDO MAGALHAES;317;STC;CORTE;2022-08-09;22;20;2;3;N
CONCEICAO DO COITE;64;STC;CORTE;2022-08-18;11;11;0;5;N
SENHOR DO BONFIM;447;EPS;CORTE;2022-08-12;6;6;0;6;N
IPIAU;526;EPS;CORTE;2022-08-22;12;12;0;2;N
SANTA MARIA DA VITORIA;418;EPS;CORTE;2022-08-19;2;2;0;6;N
FEIRA DE SANTANA SUL;123;EPS;BAIXA;2022-08-11;12;2;10;5;N
SEABRA;436;EPS;CORTE;2022-08-11;5;5;0;5;N
PIRAJA;352;EPS;CORTE;2022-08-05;17;0;17;6;N
IRECE;192;EPS;CORTE;2022-08-05;7;0;7;6;N
CAMACARI;50;STC;RECORTE;2022-08-25;16;11;5;5;N
SANTO ANTONIO DE JESUS;428;STC;RECORTE;2022-08-25;20;14;6;5;N
LAURO DE FREITAS;294;EPS;CORTE;2022-08-12;16;16;0;6;N
CANDEIAS;59;STC;RECORTE;2022-08-12;16;8;8;6;N
GRACA;135;EPS;CORTE;2022-08-15;21;20;1;2;N
PAULO AFONSO;331;STC;CORTE;2022-08-02;11;11;0;3;N
JACOBINA;264;EPS;CORTE;2022-08-17;7;7;0;4;N
BOM JESUS DA LAPA;28;STC;CORTE;2022-08-16;11;11;0;3;N
PERIPERI;348;STC;RECORTE;2022-08-16;48;34;14;3;N
JUAZEIRO;286;EPS;CORTE;2022-08-08;20;20;0;2;N
JUAZEIRO;286;STC;CORTE;2022-08-22;9;9;0;2;N
ITABERABA;217;EPS;CORTE;2022-08-15;4;4;0;2;N
REMANSO;390;EPS;RECORTE;2022-08-10;6;6;0;4;N
CANDEIAS;58;EPS;RECORTE;2022-08-10;9;9;0;4;N
POSTO DA MATA;383;EPS;CORTE;2022-08-02;9;8;1;3;N
LAURO DE FREITAS;295;STC;CORTE;2022-08-12;18;18;0;6;S
JACOBINA;259;EPS;BAIXA;2022-08-04;5;5;0;5;N
VITORIA DA CONQUISTA;522;STC;CORTE;2022-08-08;11;11;0;2;N
EUNAPOLIS;97;EPS;BAIXA;2022-08-18;2;1;1;5;N
CAMACARI;55;EPS;CORTE;2022-08-24;19;17;2;4;N
POSTO DA MATA;387;STC;RECORTE;2022-08-16;10;7;3;3;S
JEQUIE;267;STC;CORTE;2022-08-22;11;11;0;2;N
BARREIRAS;16;EPS;BAIXA;2022-08-10;5;4;1;4;N
AMARGOSA;6;EPS;CORTE;2022-08-02;7;7;0;3;N
PAULO AFONSO;343;EPS;CORTE;2022-08-16;5;5;0;3;N
IBOTIRAMA;166;STC;RECORTE;2022-08-22;11;10;1;2;N
PAULO AFONSO;329;STC;CORTE;2022-08-24;15;15;0;4;S
CONCEICAO DO COITE;67;EPS;BAIXA;2022-08-18;2;2;0;5;N
LAURO DE FREITAS;293;EPS;CORTE;2022-08-24;14;14;0;4;N
VALENCA;493;EPS;CORTE;2022-08-19;7;7;0;6;N
BARREIRAS;22;EPS;CORTE;2022-08-11;6;5;1;5;N
BRUMADO;35;STC;CORTE;2022-08-05;11;0;11;6;N
ITABERABA;219;STC;CORTE;2022-08-05;11;0;11;6;N
GRACA;137;STC;CORTE;2022-08-05;17;0;17;6;N
ITABUNA;233;STC;RECORTE;2022-08-24;18;17;1;4;N
IRECE;211;EPS;CORTE;2022-08-23;60;59;1;3;N
ITABERABA;214;STC;CORTE;2022-08-16;11;11;0;3;N
JACOBINA;260;EPS;CORTE;2022-08-16;8;8;0;3;N
JACOBINA;261;STC;CORTE;2022-08-18;34;34;0;5;N
LIVRAMENTO DE NOSSA SENHORA;301;STC;CORTE;2022-08-15;9;9;0;2;N
ITAPOAN;252;STC;CORTE;2022-08-22;99;96;3;2;N
SENHOR DO BONFIM;454;EPS;CORTE;2022-08-02;16;14;2;3;N
ESPLANADA;78;STC;CORTE;2022-08-11;22;22;0;5;N
VITORIA DA CONQUISTA;517;STC;CORTE;2022-08-19;10;9;1;6;N
AMARGOSA;6;EPS;RECORTE;2022-08-03;5;5;0;4;N
BOM JESUS DA LAPA;30;EPS;CORTE;2022-08-04;6;6;0;5;N
CAMACARI;51;EPS;CORTE;2022-08-23;20;16;4;3;N
ITAPOAN;252;EPS;CORTE;2022-08-08;50;50;0;2;N
ESPLANADA;77;EPS;CORTE;2022-08-09;17;17;0;3;N
CAMACARI;55;EPS;RECORTE;2022-08-25;22;16;6;5;N
PAULO AFONSO;325;EPS;CORTE;2022-08-11;8;6;2;5;N
JACOBINA;264;EPS;RECORTE;2022-08-18;9;9;0;5;N
SERRINHA;467;STC;CORTE;2022-08-19;11;11;0;6;N
LUIS EDUARDO MAGALHAES;322;STC;CORTE;2022-08-23;16;16;0;3;N
IRECE;197;EPS;CORTE;2022-08-19;16;14;2;6;N
AMARGOSA;10;EPS;BAIXA;2022-08-04;4;4;0;5;N
ITABUNA;233;EPS;BAIXA;2022-08-10;3;1;2;4;N
LIVRAMENTO DE NOSSA SENHORA;305;STC;RECORTE;2022-08-17;3;3;0;4;N
LAURO DE FREITAS;295;STC;RECORTE;2022-08-15;16;16;0;2;N
ILHEUS;186;STC;RECORTE;2022-08-09;9;3;6;3;S
EUNAPOLIS;97;STC;RECORTE;2022-08-09;21;12;9;3;N
CANDEIAS;58;EPS;BAIXA;2022-08-10;5;4;1;4;N
PAULO AFONSO;325;STC;CORTE;2022-08-25;16;16;0;5;N
SEABRA;442;STC;CORTE;2022-08-25;11;11;0;5;S
PAULO AFONSO;341;STC;CORTE;2022-08-05;11;0;11;6;N
CONCEICAO DO COITE;62;EPS;CORTE;2022-08-05;9;0;9;6;N
SEABRA;441;EPS;CORTE;2022-08-25;10;0;10;5;N
AMARGOSA;11;EPS;CORTE;2022-08-16;15;15;0;3;N
SEABRA;440;STC;CORTE;2022-08-02;11;9;2;3;N
PIRAJA;353;EPS;CORTE;2022-08-18;42;40;2;5;N
BOM JESUS DA LAPA;25;EPS;CORTE;2022-08-15;5;5;0;2;N
GRACA;133;EPS;CORTE;2022-08-16;21;21;0;3;N
GRACA;134;EPS;CORTE;2022-08-04;17;16;1;5;N
PITUBA;359;EPS;CORTE;2022-08-16;19;18;1;3;N
FEIRA DE SANTANA SUL;122;EPS;CORTE;2022-08-24;18;17;1;4;N
ITABUNA;227;EPS;CORTE;2022-08-09;18;17;1;3;N
SENHOR DO BONFIM;450;STC;CORTE;2022-08-15;13;13;0;2;N
SANTO AMARO;424;EPS;CORTE;2022-08-15;22;21;1;2;N
SENHOR DO BONFIM;454;EPS;RECORTE;2022-08-03;20;20;0;4;N
JUAZEIRO;291;EPS;CORTE;2022-08-22;13;12;1;2;N
TEIXEIRA DE FREITAS;482;EPS;CORTE;2022-08-16;10;9;1;3;N
SERRINHA;463;STC;CORTE;2022-08-18;9;9;0;5;N
TEIXEIRA DE FREITAS;470;STC;CORTE;2022-08-02;17;17;0;3;N
FEIRA DE SANTANA SUL;123;EPS;CORTE;2022-08-12;54;47;7;6;N
ITABERABA;216;EPS;CORTE;2022-08-04;6;5;1;5;N
JUAZEIRO;292;EPS;CORTE;2022-08-10;15;15;0;4;N
VALENCA;491;STC;RECORTE;2022-08-09;17;15;2;3;N
GUANAMBI;150;EPS;CORTE;2022-08-12;7;7;0;6;N
JACOBINA;264;EPS;BAIXA;2022-08-18;1;1;0;5;N
ESPLANADA;77;EPS;RECORTE;2022-08-10;6;3;3;4;N
SEABRA;438;EPS;CORTE;2022-08-12;14;14;0;6;N
SERRINHA;455;EPS;CORTE;2022-08-03;5;5;0;4;N
POSTO DA MATA;388;EPS;CORTE;2022-08-16;19;18;1;3;N
ITAPOAN;253;STC;RECORTE;2022-08-09;5;1;4;3;S
IRECE;207;EPS;CORTE;2022-08-22;13;12;1;2;N
EUNAPOLIS;89;EPS;DISJUNTOR;2022-08-24;4;4;0;4;N
SANTA MARIA DA VITORIA;412;EPS;CORTE;2022-08-19;2;2;0;6;N
IRECE;211;EPS;RECORTE;2022-08-24;15;15;0;4;N
PAULO AFONSO;324;EPS;RECORTE;2022-08-24;2;1;1;4;N
PORTO SEGURO;375;EPS;CORTE;2022-08-05;8;0;8;6;N
CAMACARI;50;EPS;CORTE;2022-08-12;22;22;0;6;N
PITUBA;359;EPS;RECORTE;2022-08-17;39;36;3;4;N
ALAGOINHAS;3;EPS;CORTE;2022-08-02;11;11;0;3;N
ALAGOINHAS;4;STC;CORTE;2022-08-04;11;10;1;5;N
ALAGOINHAS;3;STC;CORTE;2022-08-16;12;12;0;3;N
SANTO ANTONIO DE JESUS;428;EPS;CORTE;2022-08-12;10;10;0;6;N
ITABERABA;215;EPS;RECORTE;2022-08-17;3;3;0;4;N
AMARGOSA;11;EPS;RECORTE;2022-08-17;20;20;0;4;N
IRECE;204;STC;CORTE;2022-08-23;14;13;1;3;N
VITORIA DA CONQUISTA;518;EPS;DISJUNTOR;2022-08-02;42;40;2;3;N
ESPLANADA;83;EPS;CORTE;2022-08-11;12;12;0;5;N
LIVRAMENTO DE NOSSA SENHORA;300;STC;CORTE;2022-08-04;3;3;0;5;N
JUAZEIRO;288;STC;CORTE;2022-08-23;10;9;1;3;N
LUIS EDUARDO MAGALHAES;323;EPS;RECORTE;2022-08-24;6;6;0;4;N
FEIRA DE SANTANA SUL;122;EPS;RECORTE;2022-08-25;30;21;9;5;N
ITAPETINGA;238;EPS;CORTE;2022-08-12;12;12;0;6;N
REMANSO;394;EPS;CORTE;2022-08-12;8;8;0;6;N
LUIS EDUARDO MAGALHAES;319;EPS;CORTE;2022-08-22;4;4;0;2;N
VITORIA DA CONQUISTA;502;STC;CORTE;2022-08-04;11;11;0;5;N
SANTO ANTONIO DE JESUS;431;EPS;RECORTE;2022-08-24;7;3;4;4;S
SANTO ANTONIO DE JESUS;8;EPS;RECORTE;2022-08-24;10;3;7;4;S
SANTO AMARO;422;STC;CORTE;2022-08-04;9;9;0;5;N
ITABERABA;213;STC;CORTE;2022-08-03;14;14;0;4;S
ESPLANADA;77;EPS;BAIXA;2022-08-10;4;4;0;4;N
BRUMADO;35;EPS;CORTE;2022-08-16;7;7;0;3;N
IRECE;205;STC;CORTE;2022-08-11;11;11;0;5;N
PITUBA;358;EPS;DISJUNTOR;2022-08-11;14;13;1;5;N
SENHOR DO BONFIM;452;EPS;BAIXA;2022-08-25;16;16;0;5;S
PORTO SEGURO;363;EPS;BAIXA;2022-08-25;15;15;0;5;S
SANTO AMARO;422;EPS;DISJUNTOR;2022-08-22;12;11;1;2;N
PITUBA;357;EPS;DISJUNTOR;2022-08-23;32;28;4;3;N
CAMACARI;51;STC;CORTE;2022-08-12;6;6;0;6;S
SANTO AMARO;421;STC;CORTE;2022-08-16;9;9;0;3;N
FEIRA DE SANTANA NORTE;107;STC;CORTE;2022-08-08;2;2;0;2;N
RIBEIRA DO POMBAL;398;STC;CORTE;2022-08-25;11;10;1;5;N
TEIXEIRA DE FREITAS;480;EPS;DISJUNTOR;2022-08-23;20;20;0;3;N
ITABUNA;185;EPS;CORTE;2022-08-23;14;12;2;3;N
CONCEICAO DO COITE;67;EPS;CORTE;2022-08-19;7;7;0;6;N
PITUBA;357;STC;CORTE;2022-08-05;19;0;19;6;N
JACOBINA;259;EPS;CORTE;2022-08-05;7;0;7;6;N
IPIAU;530;EPS;CORTE;2022-08-25;7;0;7;5;N
RIBEIRA DO POMBAL;409;EPS;CORTE;2022-08-02;10;10;0;3;N
IPIAU;527;EPS;CORTE;2022-08-12;8;8;0;6;N
JACOBINA;255;STC;CORTE;2022-08-18;19;19;0;5;N
ITABUNA;233;EPS;CORTE;2022-08-11;13;13;0;5;N
REMANSO;393;EPS;RECORTE;2022-08-25;60;54;6;5;N
BARREIRAS;13;STC;CORTE;2022-08-12;15;15;0;6;N
REMANSO;390;STC;CORTE;2022-08-23;18;18;0;3;S
EUNAPOLIS;87;EPS;BAIXA;2022-08-17;4;2;2;4;N
JACOBINA;258;EPS;RECORTE;2022-08-18;9;9;0;5;N
PERIPERI;347;EPS;CORTE;2022-08-15;28;27;1;2;N
LIVRAMENTO DE NOSSA SENHORA;309;STC;CORTE;2022-08-17;15;15;0;4;S
IPIAU;532;STC;RECORTE;2022-08-16;16;16;0;3;N
VALENCA;496;STC;RECORTE;2022-08-23;21;20;1;3;N
LUIS EDUARDO MAGALHAES;317;STC;CORTE;2022-08-11;11;11;0;5;N
ITABUNA;185;EPS;RECORTE;2022-08-24;11;10;1;4;N
PAULO AFONSO;407;STC;CORTE;2022-08-23;11;11;0;3;N
TEIXEIRA DE FREITAS;479;STC;RECORTE;2022-08-16;20;10;10;3;S
JUAZEIRO;291;EPS;BAIXA;2022-08-23;17;17;0;3;N
AMARGOSA;11;EPS;BAIXA;2022-08-17;2;2;0;4;N
SENHOR DO BONFIM;448;EPS;CORTE;2022-08-02;8;8;0;3;N
CAMACARI;51;STC;RECORTE;2022-08-15;16;16;0;2;N
CONCEICAO DO COITE;67;EPS;DISJUNTOR;2022-08-02;4;4;0;3;N
CANDEIAS;58;STC;CORTE;2022-08-25;8;8;0;5;N
IBOTIRAMA;166;EPS;CORTE;2022-08-09;5;4;1;3;N
SANTO AMARO;425;EPS;BAIXA;2022-08-04;14;8;6;5;N
POSTO DA MATA;387;EPS;CORTE;2022-08-05;9;0;9;6;N
BOM JESUS DA LAPA;32;EPS;CORTE;2022-08-05;5;0;5;6;N
VITORIA DA CONQUISTA;511;EPS;CORTE;2022-08-05;14;0;14;6;N
JEQUIE;282;STC;CORTE;2022-08-16;6;6;0;3;N
PAULO AFONSO;330;STC;CORTE;2022-08-16;11;11;0;3;N
SANTO ANTONIO DE JESUS;435;STC;CORTE;2022-08-16;19;18;1;3;N
FEIRA DE SANTANA NORTE;116;EPS;RECORTE;2022-08-10;48;46;2;4;N
ITABUNA;230;STC;CORTE;2022-08-12;32;31;1;6;N
JUAZEIRO;285;EPS;CORTE;2022-08-22;15;14;1;2;N
VITORIA DA CONQUISTA;506;EPS;CORTE;2022-08-16;15;15;0;3;N
POSTO DA MATA;383;STC;CORTE;2022-08-18;17;17;0;5;N
JACOBINA;534;EPS;CORTE;2022-08-16;8;8;0;3;N
BOM JESUS DA LAPA;28;STC;CORTE;2022-08-18;16;13;3;5;N
VALENCA;494;EPS;CORTE;2022-08-09;8;8;0;3;N
AMARGOSA;5;EPS;CORTE;2022-08-16;10;10;0;3;N
EUNAPOLIS;85;EPS;RECORTE;2022-08-18;3;3;0;5;N
SERRINHA;456;EPS;CORTE;2022-08-16;7;6;1;3;N
LIVRAMENTO DE NOSSA SENHORA;305;EPS;CORTE;2022-08-04;6;6;0;5;N
JEQUIE;270;EPS;RECORTE;2022-08-24;10;10;0;4;N
ITABUNA;232;EPS;RECORTE;2022-08-24;11;10;1;4;N
SENHOR DO BONFIM;448;EPS;RECORTE;2022-08-03;14;14;0;4;N
JUAZEIRO;286;EPS;CORTE;2022-08-10;15;14;1;4;N
REMANSO;389;EPS;RECORTE;2022-08-24;28;25;3;4;N
LAURO DE FREITAS;295;EPS;CORTE;2022-08-02;15;14;1;3;N
JEQUIE;282;EPS;CORTE;2022-08-02;4;4;0;3;N
ITABERABA;217;EPS;CORTE;2022-08-17;9;9;0;4;N
LUIS EDUARDO MAGALHAES;320;EPS;BAIXA;2022-08-11;14;13;1;5;N
GRACA;130;EPS;BAIXA;2022-08-04;11;7;4;5;N
CAMACARI;57;STC;CORTE;2022-08-16;12;12;0;3;N
JACOBINA;264;EPS;CORTE;2022-08-19;8;8;0;6;N
JEQUIE;273;STC;RECORTE;2022-08-02;11;11;0;3;N
LAURO DE FREITAS;295;STC;CORTE;2022-08-16;16;12;4;3;N
BOM JESUS DA LAPA;33;STC;RECORTE;2022-08-08;11;11;0;2;N
PERIPERI;348;STC;RECORTE;2022-08-18;19;18;1;5;N
JEQUIE;266;EPS;CORTE;2022-08-22;2;2;0;2;N
PORTO SEGURO;369;EPS;CORTE;2022-08-05;8;0;8;6;N
ITABERABA;218;EPS;CORTE;2022-08-05;5;0;5;6;N
GRACA;136;EPS;CORTE;2022-08-05;54;0;54;6;N
PAULO AFONSO;407;STC;RECORTE;2022-08-24;9;7;2;4;N
LUIS EDUARDO MAGALHAES;316;STC;RECORTE;2022-08-24;7;7;0;4;N
VITORIA DA CONQUISTA;519;EPS;DISJUNTOR;2022-08-15;25;23;2;2;N
POSTO DA MATA;378;EPS;CORTE;2022-08-15;6;6;0;2;N
FEIRA DE SANTANA SUL;127;EPS;CORTE;2022-08-15;18;18;0;2;N
LUIS EDUARDO MAGALHAES;321;EPS;CORTE;2022-08-23;8;8;0;3;N
IPIAU;190;EPS;CORTE;2022-08-11;8;8;0;5;N
AMARGOSA;5;EPS;RECORTE;2022-08-17;10;10;0;4;N
SEABRA;442;EPS;CORTE;2022-08-15;16;15;1;2;N
PERIPERI;348;EPS;BAIXA;2022-08-04;15;11;4;5;N
JACOBINA;262;STC;CORTE;2022-08-08;16;16;0;2;N
SERRINHA;468;STC;CORTE;2022-08-09;11;11;0;3;N
FEIRA DE SANTANA NORTE;113;STC;RECORTE;2022-08-11;15;14;1;5;N
IBOTIRAMA;163;STC;RECORTE;2022-08-09;4;4;0;3;S
VALENCA;490;EPS;CORTE;2022-08-08;19;19;0;2;N
ITAPOAN;253;STC;CORTE;2022-08-12;19;18;1;6;N
SENHOR DO BONFIM;454;STC;CORTE;2022-08-18;13;13;0;5;N
GUANAMBI;142;EPS;DISJUNTOR;2022-08-19;15;15;0;6;N
GRACA;132;STC;CORTE;2022-08-18;17;15;2;5;N
IBOTIRAMA;171;EPS;CORTE;2022-08-23;7;7;0;3;N
JEQUIE;278;STC;CORTE;2022-08-15;11;8;3;2;N
VALENCA;490;STC;CORTE;2022-08-22;17;17;0;2;N
FEIRA DE SANTANA SUL;128;EPS;CORTE;2022-08-03;12;11;1;4;N
GRACA;137;STC;RECORTE;2022-08-08;17;13;4;2;N
SENHOR DO BONFIM;454;EPS;CORTE;2022-08-04;7;7;0;5;N
VITORIA DA CONQUISTA;518;STC;CORTE;2022-08-09;11;10;1;3;N
ITABUNA;232;EPS;BAIXA;2022-08-24;2;2;0;4;N
BARREIRAS;18;EPS;CORTE;2022-08-12;6;6;0;6;N
PAULO AFONSO;326;STC;CORTE;2022-08-15;11;10;1;2;N
IRECE;211;EPS;CORTE;2022-08-23;45;45;0;3;S
ESPLANADA;77;EPS;CORTE;2022-08-11;14;12;2;5;N
SERRINHA;466;EPS;CORTE;2022-08-19;6;6;0;6;N
ITAPOAN;252;STC;CORTE;2022-08-22;11;11;0;2;S
JUAZEIRO;287;STC;RECORTE;2022-08-11;2;1;1;5;S
LUIS EDUARDO MAGALHAES;322;STC;CORTE;2022-08-25;16;15;1;5;N
IPIAU;190;STC;CORTE;2022-08-25;13;13;0;5;N
IPIAU;189;EPS;CORTE;2022-08-23;7;7;0;3;N
GUANAMBI;139;EPS;CORTE;2022-08-23;5;4;1;3;N
IRECE;198;EPS;CORTE;2022-08-09;14;14;0;3;N
FEIRA DE SANTANA NORTE;109;STC;CORTE;2022-08-09;1;1;0;3;N
PAULO AFONSO;340;EPS;CORTE;2022-08-05;9;0;9;6;N
ILHEUS;179;EPS;DISJUNTOR;2022-08-16;32;32;0;3;N
SANTA MARIA DA VITORIA;414;STC;CORTE;2022-08-11;11;11;0;5;N
FEIRA DE SANTANA SUL;124;STC;CORTE;2022-08-16;16;15;1;3;N
ITABUNA;227;EPS;CORTE;2022-08-11;13;12;1;5;N
VALENCA;490;STC;RECORTE;2022-08-23;17;17;0;3;N
SENHOR DO BONFIM;453;EPS;RECORTE;2022-08-17;10;9;1;4;N
FEIRA DE SANTANA SUL;128;EPS;RECORTE;2022-08-04;16;14;2;5;N
EUNAPOLIS;103;STC;CORTE;2022-08-12;15;13;2;6;N
FEIRA DE SANTANA SUL;124;EPS;CORTE;2022-08-02;18;18;0;3;N
PIRAJA;354;STC;CORTE;2022-08-22;17;17;0;2;N
PIRAJA;354;EPS;CORTE;2022-08-08;38;37;1;2;N
PORTO SEGURO;377;EPS;DISJUNTOR;2022-08-15;17;17;0;2;N
JUAZEIRO;292;EPS;CORTE;2022-08-12;15;15;0;6;N
ILHEUS;180;STC;DISJUNTOR;2022-08-16;25;25;0;3;S
SANTA MARIA DA VITORIA;417;STC;DISJUNTOR;2022-08-05;20;20;0;6;S
IRECE;198;EPS;RECORTE;2022-08-10;8;8;0;4;N
SANTO ANTONIO DE JESUS;9;EPS;CORTE;2022-08-15;8;8;0;2;N
IPIAU;189;EPS;RECORTE;2022-08-24;8;8;0;4;N
TEIXEIRA DE FREITAS;473;STC;RECORTE;2022-08-16;6;5;1;3;S
IBOTIRAMA;169;STC;CORTE;2022-08-12;9;9;0;6;N
SERRINHA;456;EPS;BAIXA;2022-08-17;24;23;1;4;N
AMARGOSA;5;EPS;BAIXA;2022-08-17;2;2;0;4;N
BOM JESUS DA LAPA;27;EPS;BAIXA;2022-08-17;4;4;0;4;N
CAMACARI;55;EPS;BAIXA;2022-08-25;28;19;9;5;S
BRUMADO;41;STC;CORTE;2022-08-09;11;11;0;3;N
SERRINHA;467;STC;RECORTE;2022-08-22;11;8;3;2;N
BRUMADO;39;EPS;CORTE;2022-08-19;6;6;0;6;N
AMARGOSA;11;EPS;CORTE;2022-08-18;20;20;0;5;N
PITUBA;359;EPS;CORTE;2022-08-18;18;17;1;5;N
BARREIRAS;14;STC;CORTE;2022-08-25;12;12;0;5;N
SENHOR DO BONFIM;449;EPS;CORTE;2022-08-15;6;6;0;2;N
JUAZEIRO;291;EPS;CORTE;2022-08-24;15;13;2;4;N
ITAPETINGA;244;STC;CORTE;2022-08-05;11;0;11;6;N
VITORIA DA CONQUISTA;505;EPS;CORTE;2022-08-05;9;0;9;6;N
IRECE;198;STC;RECORTE;2022-08-24;21;21;0;4;N
VITORIA DA CONQUISTA;520;EPS;BAIXA;2022-08-19;19;0;19;6;S
LAURO DE FREITAS;298;EPS;DISJUNTOR;2022-08-23;36;35;1;3;N
FEIRA DE SANTANA NORTE;106;EPS;CORTE;2022-08-08;11;10;1;2;N
ALAGOINHAS;2;EPS;CORTE;2022-08-16;30;28;2;3;N
ILHEUS;187;EPS;CORTE;2022-08-11;22;20;2;5;N
SENHOR DO BONFIM;454;EPS;BAIXA;2022-08-05;15;15;0;6;N
CAMACARI;55;EPS;RECORTE;2022-08-04;18;18;0;5;N
BRUMADO;49;EPS;CORTE;2022-08-22;6;6;0;2;N
ILHEUS;186;EPS;CORTE;2022-08-23;20;17;3;3;N
CAMACARI;51;EPS;CORTE;2022-08-02;18;17;1;3;N
ITAPETINGA;239;STC;CORTE;2022-08-16;9;8;1;3;N
LUIS EDUARDO MAGALHAES;322;STC;CORTE;2022-08-02;11;11;0;3;N
VALENCA;495;EPS;CORTE;2022-08-22;35;35;0;2;N
SANTO AMARO;423;EPS;DISJUNTOR;2022-08-12;3;3;0;6;N
PITUBA;356;STC;CORTE;2022-08-19;38;32;6;6;N
ITABUNA;172;EPS;CORTE;2022-08-09;18;18;0;3;N
ALAGOINHAS;3;STC;CORTE;2022-08-18;1;1;0;5;N
SANTO AMARO;420;EPS;CORTE;2022-08-16;11;11;0;3;N
IPIAU;531;EPS;CORTE;2022-08-15;8;8;0;2;N
SANTO AMARO;421;STC;CORTE;2022-08-18;21;20;1;5;N
SANTO AMARO;421;STC;CORTE;2022-08-16;20;20;0;3;S
JUAZEIRO;291;EPS;RECORTE;2022-08-25;11;8;3;5;N
VITORIA DA CONQUISTA;500;EPS;CORTE;2022-08-16;15;14;1;3;N
SANTO ANTONIO DE JESUS;430;STC;CORTE;2022-08-04;13;9;4;5;N
SANTO AMARO;421;EPS;CORTE;2022-08-04;15;14;1;5;N
ALAGOINHAS;3;EPS;CORTE;2022-08-04;12;12;0;5;N
VITORIA DA CONQUISTA;501;STC;CORTE;2022-08-18;11;11;0;5;N
LUIS EDUARDO MAGALHAES;320;EPS;CORTE;2022-08-12;7;7;0;6;N
ITAPOAN;252;EPS;BAIXA;2022-08-11;15;11;4;5;N
FEIRA DE SANTANA NORTE;110;EPS;RECORTE;2022-08-10;51;49;2;4;N
ITABUNA;226;EPS;RECORTE;2022-08-24;11;6;5;4;N
TEIXEIRA DE FREITAS;484;STC;RECORTE;2022-08-09;17;7;10;3;N
RIBEIRA DO POMBAL;399;STC;CORTE;2022-08-15;11;11;0;2;N
IPIAU;189;EPS;BAIXA;2022-08-24;4;3;1;4;N
VALENCA;498;EPS;DISJUNTOR;2022-08-18;13;12;1;5;N
IRECE;204;STC;CORTE;2022-08-25;16;16;0;5;N
JUAZEIRO;287;EPS;CORTE;2022-08-23;8;8;0;3;N
PAULO AFONSO;345;EPS;CORTE;2022-08-19;8;8;0;6;N
FEIRA DE SANTANA SUL;128;EPS;BAIXA;2022-08-04;7;4;3;5;N
CONCEICAO DO COITE;68;EPS;CORTE;2022-08-09;7;7;0;3;N
IBOTIRAMA;156;EPS;CORTE;2022-08-08;5;5;0;2;N
PITUBA;356;EPS;CORTE;2022-08-05;42;0;42;6;N
TEIXEIRA DE FREITAS;479;EPS;CORTE;2022-08-05;13;0;13;6;N
GRACA;130;EPS;CORTE;2022-08-05;75;0;75;6;N
PITUBA;357;EPS;DISJUNTOR;2022-08-25;50;0;50;5;N
ESPLANADA;82;EPS;CORTE;2022-08-25;14;0;14;5;N
SENHOR DO BONFIM;448;EPS;CORTE;2022-08-04;7;7;0;5;N
SANTO ANTONIO DE JESUS;429;EPS;RECORTE;2022-08-03;8;8;0;4;N
SANTO AMARO;420;EPS;RECORTE;2022-08-17;21;19;2;4;N
ITABUNA;184;STC;CORTE;2022-08-02;16;16;0;3;N
ITAPOAN;254;EPS;CORTE;2022-08-11;23;23;0;5;N
JACOBINA;256;STC;CORTE;2022-08-08;14;14;0;2;N
SEABRA;444;EPS;CORTE;2022-08-16;14;14;0;3;N
SANTA MARIA DA VITORIA;535;EPS;CORTE;2022-08-17;20;19;1;4;N
ILHEUS;186;EPS;RECORTE;2022-08-24;8;8;0;4;N
PAULO AFONSO;407;EPS;CORTE;2022-08-11;7;6;1;5;N
VALENCA;493;STC;CORTE;2022-08-11;17;17;0;5;N
PAULO AFONSO;324;EPS;RECORTE;2022-08-03;6;6;0;4;N
IRECE;204;STC;RECORTE;2022-08-24;15;11;4;4;S
PITUBA;357;STC;RECORTE;2022-08-08;21;19;2;2;N
FEIRA DE SANTANA SUL;122;EPS;BAIXA;2022-08-25;48;43;5;5;S
CANDEIAS;59;STC;CORTE;2022-08-15;11;11;0;2;N
IRECE;192;EPS;CORTE;2022-08-09;14;13;1;3;N
ALAGOINHAS;2;EPS;RECORTE;2022-08-17;14;13;1;4;N
ITABUNA;233;STC;CORTE;2022-08-25;9;9;0;5;S
BRUMADO;46;STC;CORTE;2022-08-23;10;9;1;3;N
IRECE;203;EPS;RECORTE;2022-08-24;15;15;0;4;N
PERIPERI;348;EPS;CORTE;2022-08-05;30;0;30;6;N
VALENCA;496;STC;RECORTE;2022-08-25;16;16;0;5;N
GRACA;135;EPS;CORTE;2022-08-19;84;83;1;6;N
ITABUNA;229;EPS;CORTE;2022-08-12;15;15;0;6;N
ITAPETINGA;245;STC;CORTE;2022-08-18;9;9;0;5;N
VITORIA DA CONQUISTA;521;EPS;CORTE;2022-08-10;30;26;4;4;N
BOM JESUS DA LAPA;27;EPS;CORTE;2022-08-18;5;5;0;5;N
ILHEUS;175;EPS;RECORTE;2022-08-10;7;7;0;4;N
FEIRA DE SANTANA SUL;122;EPS;RECORTE;2022-08-04;16;16;0;5;N
FEIRA DE SANTANA NORTE;113;STC;CORTE;2022-08-12;15;14;1;6;N
JUAZEIRO;286;EPS;CORTE;2022-08-12;15;15;0;6;N
ITAPOAN;252;EPS;DISJUNTOR;2022-08-18;28;27;1;5;N
CAMACARI;57;STC;CORTE;2022-08-18;6;6;0;5;N
GRACA;137;STC;CORTE;2022-08-09;17;15;2;3;N
SANTO ANTONIO DE JESUS;434;EPS;CORTE;2022-08-16;8;8;0;3;N
JUAZEIRO;288;STC;CORTE;2022-08-02;9;9;0;3;N
ITABUNA;231;STC;CORTE;2022-08-02;16;15;1;3;N
LAURO DE FREITAS;295;STC;CORTE;2022-08-16;5;5;0;3;S
REMANSO;391;STC;RECORTE;2022-08-16;11;11;0;3;N
CANDEIAS;59;STC;RECORTE;2022-08-16;32;30;2;3;N
CONCEICAO DO COITE;64;STC;RECORTE;2022-08-23;11;8;3;3;N
BRUMADO;46;EPS;RECORTE;2022-08-10;4;4;0;4;N
VITORIA DA CONQUISTA;520;EPS;CORTE;2022-08-22;4;4;0;2;N
PAULO AFONSO;402;EPS;CORTE;2022-08-22;7;7;0;2;N
SANTO ANTONIO DE JESUS;435;EPS;CORTE;2022-08-04;6;6;0;5;N
RIBEIRA DO POMBAL;405;EPS;CORTE;2022-08-03;8;8;0;4;N
IRECE;192;EPS;RECORTE;2022-08-10;8;8;0;4;N
SENHOR DO BONFIM;447;EPS;RECORTE;2022-08-17;11;9;2;4;N
SANTO ANTONIO DE JESUS;426;STC;RECORTE;2022-08-04;17;15;2;5;N
ALAGOINHAS;2;EPS;BAIXA;2022-08-17;6;6;0;4;N
IRECE;203;EPS;BAIXA;2022-08-24;2;2;0;4;N
IBOTIRAMA;162;EPS;CORTE;2022-08-10;5;5;0;4;N
AMARGOSA;5;EPS;CORTE;2022-08-18;20;18;2;5;N
VITORIA DA CONQUISTA;508;STC;CORTE;2022-08-08;11;9;2;2;N
ILHEUS;186;EPS;BAIXA;2022-08-24;2;1;1;4;N
IRECE;211;STC;CORTE;2022-08-15;11;11;0;2;N
LIVRAMENTO DE NOSSA SENHORA;306;STC;CORTE;2022-08-08;4;2;2;2;N
LUIS EDUARDO MAGALHAES;318;STC;RECORTE;2022-08-02;8;8;0;3;N
REMANSO;392;STC;RECORTE;2022-08-04;11;11;0;5;N
IBOTIRAMA;161;EPS;CORTE;2022-08-22;7;7;0;2;N
PERIPERI;349;STC;RECORTE;2022-08-08;19;10;9;2;N
ITABERABA;217;EPS;CORTE;2022-08-19;3;3;0;6;N
IPIAU;532;EPS;BAIXA;2022-08-04;6;6;0;5;N
RIBEIRA DO POMBAL;406;STC;CORTE;2022-08-05;11;0;11;6;N
GRACA;129;EPS;BAIXA;2022-08-18;1;0;1;5;N
VITORIA DA CONQUISTA;519;EPS;DISJUNTOR;2022-08-17;52;52;0;4;N
CAMACARI;52;EPS;CORTE;2022-08-15;22;22;0;2;N
JACOBINA;261;EPS;CORTE;2022-08-08;11;11;0;2;N
PAULO AFONSO;325;EPS;CORTE;2022-08-15;8;8;0;2;N
JUAZEIRO;285;EPS;RECORTE;2022-08-25;11;7;4;5;N
IRECE;197;EPS;CORTE;2022-08-23;20;16;4;3;N
FEIRA DE SANTANA SUL;127;EPS;CORTE;2022-08-17;18;16;2;4;N
BARREIRAS;20;STC;CORTE;2022-08-04;15;15;0;5;N
JEQUIE;277;EPS;CORTE;2022-08-15;21;21;0;2;N
LUIS EDUARDO MAGALHAES;323;STC;CORTE;2022-08-15;11;11;0;2;N
VALENCA;489;EPS;CORTE;2022-08-22;12;12;0;2;N
CAMACARI;53;EPS;CORTE;2022-08-03;13;12;1;4;N
ITABUNA;228;STC;DISJUNTOR;2022-08-19;20;20;0;6;S
JEQUIE;281;EPS;RECORTE;2022-08-17;9;5;4;4;N
VITORIA DA CONQUISTA;521;EPS;RECORTE;2022-08-11;15;11;4;5;N
IBOTIRAMA;159;STC;CORTE;2022-08-11;9;9;0;5;N
SERRINHA;467;STC;CORTE;2022-08-23;11;11;0;3;N
FEIRA DE SANTANA NORTE;108;STC;CORTE;2022-08-23;3;3;0;3;N
BRUMADO;46;EPS;BAIXA;2022-08-10;1;1;0;4;N
GRACA;131;EPS;CORTE;2022-08-18;21;19;2;5;N
ITABERABA;213;EPS;CORTE;2022-08-18;3;2;1;5;N
JACOBINA;261;STC;CORTE;2022-08-22;5;5;0;2;N
JUAZEIRO;287;STC;RECORTE;2022-08-15;16;15;1;2;N
EUNAPOLIS;92;EPS;CORTE;2022-08-09;12;12;0;3;N
SERRINHA;467;EPS;CORTE;2022-08-09;6;6;0;3;N
JEQUIE;279;STC;CORTE;2022-08-05;10;0;10;6;N
VITORIA DA CONQUISTA;520;EPS;DISJUNTOR;2022-08-05;15;0;15;6;N
FEIRA DE SANTANA SUL;128;EPS;CORTE;2022-08-05;22;0;22;6;N
SEABRA;443;EPS;CORTE;2022-08-05;6;0;6;6;N
FEIRA DE SANTANA NORTE;112;STC;RECORTE;2022-08-25;20;13;7;5;N
ITABUNA;229;STC;RECORTE;2022-08-25;5;1;4;5;S
GUANAMBI;139;EPS;CORTE;2022-08-25;4;0;4;5;N
LUIS EDUARDO MAGALHAES;321;EPS;CORTE;2022-08-25;7;0;7;5;N
PORTO SEGURO;375;EPS;CORTE;2022-08-09;15;15;0;3;N
BOM JESUS DA LAPA;34;STC;CORTE;2022-08-22;16;16;0;2;N
PIRAJA;353;EPS;CORTE;2022-08-22;13;13;0;2;N
PIRAJA;355;STC;CORTE;2022-08-12;17;16;1;6;N
JUAZEIRO;284;STC;RECORTE;2022-08-02;16;12;4;3;N
FEIRA DE SANTANA SUL;123;EPS;CORTE;2022-08-16;54;48;6;3;N
LIVRAMENTO DE NOSSA SENHORA;311;EPS;CORTE;2022-08-08;5;5;0;2;N
ITABUNA;185;STC;CORTE;2022-08-15;10;10;0;2;N
ITAPOAN;254;STC;RECORTE;2022-08-03;19;19;0;4;N
CAMACARI;50;EPS;DISJUNTOR;2022-08-22;35;34;1;2;N
SERRINHA;463;STC;CORTE;2022-08-22;9;8;1;2;N
FEIRA DE SANTANA SUL;127;EPS;RECORTE;2022-08-18;14;14;0;5;N
GUANAMBI;138;STC;CORTE;2022-08-02;11;11;0;3;N
TEIXEIRA DE FREITAS;469;STC;CORTE;2022-08-18;16;16;0;5;N
IPIAU;188;STC;CORTE;2022-08-02;19;18;1;3;N
AMARGOSA;12;EPS;CORTE;2022-08-08;7;7;0;2;N
REMANSO;393;STC;CORTE;2022-08-16;9;9;0;3;N
FEIRA DE SANTANA SUL;124;STC;CORTE;2022-08-16;20;20;0;3;S
PERIPERI;349;EPS;CORTE;2022-08-18;10;9;1;5;N
JEQUIE;274;STC;CORTE;2022-08-16;10;10;0;3;N
IRECE;195;STC;CORTE;2022-08-12;11;11;0;6;N
SERRINHA;463;EPS;CORTE;2022-08-08;8;7;1;2;N
IBOTIRAMA;168;EPS;CORTE;2022-08-12;7;7;0;6;N
SENHOR DO BONFIM;450;STC;CORTE;2022-08-19;13;13;0;6;N
SANTO AMARO;424;EPS;CORTE;2022-08-19;19;19;0;6;N
FEIRA DE SANTANA SUL;124;STC;CORTE;2022-08-18;21;20;1;5;N
ILHEUS;180;EPS;RECORTE;2022-08-24;8;8;0;4;N
IRECE;197;EPS;RECORTE;2022-08-24;13;13;0;4;N
EUNAPOLIS;88;EPS;CORTE;2022-08-08;8;8;0;2;N
VITORIA DA CONQUISTA;520;EPS;BAIXA;2022-08-23;6;3;3;3;N
RIBEIRA DO POMBAL;404;EPS;BAIXA;2022-08-16;9;9;0;3;N
IRECE;210;STC;CORTE;2022-08-04;10;9;1;5;N
ITAPOAN;252;EPS;RECORTE;2022-08-11;38;8;30;5;S
IRECE;193;EPS;CORTE;2022-08-22;17;17;0;2;N
IRECE;198;STC;RECORTE;2022-08-24;15;9;6;4;S
JACOBINA;256;EPS;CORTE;2022-08-19;8;7;1;6;N
GUANAMBI;142;STC;RECORTE;2022-08-04;13;9;4;5;N
LUIS EDUARDO MAGALHAES;323;STC;RECORTE;2022-08-16;13;9;4;3;N
IBOTIRAMA;167;EPS;CORTE;2022-08-24;6;6;0;4;N
BARREIRAS;20;STC;RECORTE;2022-08-03;9;9;0;4;S
BRUMADO;40;EPS;CORTE;2022-08-09;6;5;1;3;N
FEIRA DE SANTANA NORTE;109;STC;RECORTE;2022-08-12;5;5;0;6;N
VALENCA;486;EPS;CORTE;2022-08-09;8;8;0;3;N
LIVRAMENTO DE NOSSA SENHORA;302;STC;RECORTE;2022-08-08;1;1;0;2;N
FEIRA DE SANTANA NORTE;108;STC;RECORTE;2022-08-24;2;0;2;4;N
BARREIRAS;13;EPS;CORTE;2022-08-25;6;0;6;5;N
PORTO SEGURO;371;EPS;CORTE;2022-08-08;11;11;0;2;N
POSTO DA MATA;386;STC;CORTE;2022-08-09;18;17;1;3;N
VITORIA DA CONQUISTA;502;STC;CORTE;2022-08-08;11;10;1;2;N
PITUBA;358;EPS;DISJUNTOR;2022-08-15;24;23;1;2;N
SENHOR DO BONFIM;445;EPS;CORTE;2022-08-16;10;9;1;3;N
SANTO ANTONIO DE JESUS;428;EPS;CORTE;2022-08-16;8;8;0;3;N
EUNAPOLIS;87;EPS;DISJUNTOR;2022-08-03;27;27;0;4;N
ITABUNA;172;EPS;CORTE;2022-08-11;13;13;0;5;N
TEIXEIRA DE FREITAS;480;STC;CORTE;2022-08-09;17;16;1;3;N
IBOTIRAMA;163;EPS;CORTE;2022-08-23;7;6;1;3;N
ITAPETINGA;239;STC;CORTE;2022-08-18;9;9;0;5;N
ESPLANADA;83;EPS;CORTE;2022-08-15;12;12;0;2;N
PITUBA;357;STC;CORTE;2022-08-09;19;18;1;3;N
LUIS EDUARDO MAGALHAES;321;EPS;CORTE;2022-08-02;9;9;0;3;N
LAURO DE FREITAS;297;STC;CORTE;2022-08-17;20;20;0;4;S
VALENCA;497;STC;CORTE;2022-08-12;15;15;0;6;S
ITABERABA;220;STC;CORTE;2022-08-22;17;17;0;2;N
EUNAPOLIS;98;STC;CORTE;2022-08-23;8;8;0;3;S
IRECE;193;STC;DISJUNTOR;2022-08-17;30;30;0;4;S
SANTO AMARO;420;EPS;CORTE;2022-08-18;10;9;1;5;N
ALAGOINHAS;2;EPS;CORTE;2022-08-18;28;24;4;5;N
ITAPETINGA;242;EPS;RECORTE;2022-08-18;11;10;1;5;N
PAULO AFONSO;332;STC;CORTE;2022-08-19;16;16;0;6;N
RIBEIRA DO POMBAL;399;EPS;CORTE;2022-08-03;10;10;0;4;N
IRECE;197;EPS;BAIXA;2022-08-24;6;2;4;4;N
IRECE;205;STC;CORTE;2022-08-15;11;11;0;2;N
IRECE;209;STC;RECORTE;2022-08-17;21;20;1;4;N
ITABERABA;224;STC;RECORTE;2022-08-24;20;20;0;4;N
SANTO AMARO;422;STC;CORTE;2022-08-08;9;9;0;2;N
ALAGOINHAS;4;STC;CORTE;2022-08-08;4;4;0;2;N
IRECE;194;STC;DISJUNTOR;2022-08-05;5;5;0;6;S
LAURO DE FREITAS;296;EPS;CORTE;2022-08-17;16;15;1;4;N
SERRINHA;463;STC;RECORTE;2022-08-23;9;8;1;3;N
FEIRA DE SANTANA SUL;124;EPS;RECORTE;2022-08-05;1;1;0;6;N
EUNAPOLIS;98;STC;CORTE;2022-08-25;8;8;0;5;N
SANTA MARIA DA VITORIA;412;EPS;RECORTE;2022-08-24;3;3;0;4;N
PIRAJA;353;EPS;DISJUNTOR;2022-08-05;15;0;15;6;N
IPIAU;532;EPS;CORTE;2022-08-05;11;0;11;6;N
IRECE;203;EPS;CORTE;2022-08-25;27;0;27;5;N
CANDEIAS;58;EPS;CORTE;2022-08-15;36;35;1;2;N
LUIS EDUARDO MAGALHAES;317;STC;CORTE;2022-08-15;11;11;0;2;N
REMANSO;390;EPS;CORTE;2022-08-15;21;21;0;2;N
RIBEIRA DO POMBAL;410;STC;CORTE;2022-08-08;11;11;0;2;N
JACOBINA;255;EPS;CORTE;2022-08-08;11;10;1;2;N
VALENCA;491;EPS;CORTE;2022-08-23;22;22;0;3;N
CONCEICAO DO COITE;65;STC;CORTE;2022-08-12;11;10;1;6;N
CANDEIAS;59;EPS;CORTE;2022-08-03;15;13;2;4;N
VITORIA DA CONQUISTA;512;STC;CORTE;2022-08-11;11;11;0;5;N
BOM JESUS DA LAPA;33;STC;CORTE;2022-08-11;11;11;0;5;N
ESPLANADA;81;STC;CORTE;2022-08-04;11;11;0;5;N
BOM JESUS DA LAPA;23;STC;RECORTE;2022-08-09;11;9;2;3;N
VALENCA;495;EPS;RECORTE;2022-08-25;2;2;0;5;N
CONCEICAO DO COITE;64;EPS;CORTE;2022-08-10;7;6;1;4;N
ALAGOINHAS;4;STC;RECORTE;2022-08-09;9;9;0;3;N
PIRAJA;354;EPS;BAIXA;2022-08-11;1;1;0;5;N
FEIRA DE SANTANA SUL;123;EPS;BAIXA;2022-08-17;10;8;2;4;N
VALENCA;492;STC;CORTE;2022-08-25;11;10;1;5;N
IRECE;200;STC;CORTE;2022-08-24;3;3;0;4;S
CONCEICAO DO COITE;63;EPS;CORTE;2022-08-22;2;2;0;2;N
IPIAU;527;EPS;CORTE;2022-08-16;8;8;0;3;N
REMANSO;389;EPS;CORTE;2022-08-25;23;22;1;5;S
ITABUNA;235;STC;CORTE;2022-08-05;14;0;14;6;N
SANTO ANTONIO DE JESUS;426;STC;CORTE;2022-08-05;13;0;13;6;N
BOM JESUS DA LAPA;32;EPS;CORTE;2022-08-09;5;5;0;3;N
ITAPOAN;253;EPS;CORTE;2022-08-25;20;0;20;5;N
ITABUNA;230;STC;CORTE;2022-08-16;16;16;0;3;N
GRACA;136;EPS;CORTE;2022-08-09;63;63;0;3;N
SANTA MARIA DA VITORIA;417;STC;CORTE;2022-08-02;11;10;1;3;N
BOM JESUS DA LAPA;28;STC;CORTE;2022-08-22;15;15;0;2;N
ITABUNA;231;STC;CORTE;2022-08-04;32;31;1;5;N
CANDEIAS;59;EPS;RECORTE;2022-08-04;16;13;3;5;N
PERIPERI;347;EPS;DISJUNTOR;2022-08-02;36;36;0;3;N
FEIRA DE SANTANA NORTE;111;EPS;CORTE;2022-08-24;24;20;4;4;N
SANTO ANTONIO DE JESUS;434;EPS;CORTE;2022-08-18;8;7;1;5;N
ITABUNA;230;EPS;CORTE;2022-08-02;16;15;1;3;N
BOM JESUS DA LAPA;28;EPS;CORTE;2022-08-08;7;6;1;2;N
ITABUNA;231;STC;CORTE;2022-08-02;20;20;0;3;S
EUNAPOLIS;90;STC;CORTE;2022-08-23;11;10;1;3;N
JEQUIE;273;STC;RECORTE;2022-08-04;40;14;26;5;S
POSTO DA MATA;383;EPS;CORTE;2022-08-08;9;9;0;2;N
CANDEIAS;533;EPS;RECORTE;2022-08-05;24;24;0;6;N
IPIAU;527;EPS;RECORTE;2022-08-17;8;7;1;4;N
AMARGOSA;6;EPS;CORTE;2022-08-08;7;7;0;2;N
BRUMADO;44;EPS;DISJUNTOR;2022-08-18;8;8;0;5;N
CONCEICAO DO COITE;64;EPS;RECORTE;2022-08-11;5;5;0;5;N
JUAZEIRO;287;EPS;CORTE;2022-08-02;8;8;0;3;N
LIVRAMENTO DE NOSSA SENHORA;305;EPS;CORTE;2022-08-08;4;4;0;2;N
SERRINHA;457;EPS;CORTE;2022-08-08;8;8;0;2;N
SANTA MARIA DA VITORIA;415;EPS;CORTE;2022-08-12;8;8;0;6;N
FEIRA DE SANTANA NORTE;113;STC;CORTE;2022-08-12;6;6;0;6;S
VITORIA DA CONQUISTA;520;EPS;CORTE;2022-08-24;14;13;1;4;N
TEIXEIRA DE FREITAS;485;EPS;CORTE;2022-08-09;10;9;1;3;N
RIBEIRA DO POMBAL;405;EPS;CORTE;2022-08-05;11;0;11;6;N
FEIRA DE SANTANA SUL;126;STC;CORTE;2022-08-19;1;1;0;6;N
TEIXEIRA DE FREITAS;481;STC;CORTE;2022-08-22;17;15;2;2;N
ITABERABA;214;STC;CORTE;2022-08-22;21;21;0;2;N
ILHEUS;186;EPS;RECORTE;2022-08-03;10;9;1;4;N
CONCEICAO DO COITE;72;STC;CORTE;2022-08-02;11;9;2;3;N
ITABERABA;217;STC;DISJUNTOR;2022-08-16;25;25;0;3;S
ITAPOAN;253;EPS;CORTE;2022-08-02;23;21;2;3;N
CAMACARI;52;EPS;CORTE;2022-08-17;42;40;2;4;N
RIBEIRA DO POMBAL;404;EPS;RECORTE;2022-08-18;11;11;0;5;N
IRECE;203;EPS;RECORTE;2022-08-03;6;6;0;4;N
FEIRA DE SANTANA NORTE;107;EPS;CORTE;2022-08-23;44;41;3;3;N
JEQUIE;278;STC;CORTE;2022-08-19;11;11;0;6;N
VALENCA;492;STC;CORTE;2022-08-02;11;11;0;3;N
VITORIA DA CONQUISTA;519;EPS;DISJUNTOR;2022-08-19;28;27;1;6;N
VALENCA;490;EPS;CORTE;2022-08-12;14;14;0;6;N
GUANAMBI;142;STC;CORTE;2022-08-03;21;21;0;4;S
ITABUNA;230;EPS;RECORTE;2022-08-03;6;6;0;4;N
IBOTIRAMA;161;EPS;RECORTE;2022-08-25;7;7;0;5;N
ITAPETINGA;241;STC;CORTE;2022-08-19;8;6;2;6;N
CAMACARI;53;STC;CORTE;2022-08-19;16;13;3;6;N
JACOBINA;262;STC;CORTE;2022-08-12;16;15;1;6;N
ALAGOINHAS;4;EPS;CORTE;2022-08-19;20;18;2;6;N
IPIAU;527;EPS;BAIXA;2022-08-17;4;4;0;4;N
VITORIA DA CONQUISTA;520;EPS;RECORTE;2022-08-25;16;11;5;5;N
SENHOR DO BONFIM;454;EPS;CORTE;2022-08-08;16;15;1;2;N
ITABUNA;234;EPS;BAIXA;2022-08-04;5;5;0;5;N
LUIS EDUARDO MAGALHAES;322;EPS;CORTE;2022-08-15;7;7;0;2;N
POSTO DA MATA;378;EPS;CORTE;2022-08-19;13;13;0;6;N
FEIRA DE SANTANA NORTE;108;EPS;CORTE;2022-08-11;40;34;6;5;N
POSTO DA MATA;380;STC;CORTE;2022-08-09;10;10;0;3;N
PAULO AFONSO;340;EPS;CORTE;2022-08-09;8;8;0;3;N
BOM JESUS DA LAPA;23;EPS;CORTE;2022-08-19;5;5;0;6;N
GRACA;132;EPS;CORTE;2022-08-08;8;8;0;2;N
FEIRA DE SANTANA NORTE;111;EPS;RECORTE;2022-08-25;36;36;0;5;N
IBOTIRAMA;163;STC;RECORTE;2022-08-15;11;10;1;2;N
SERRINHA;466;EPS;CORTE;2022-08-23;5;4;1;3;N
JACOBINA;260;EPS;CORTE;2022-08-22;5;5;0;2;N
RIBEIRA DO POMBAL;400;EPS;CORTE;2022-08-16;10;10;0;3;N
CANDEIAS;59;EPS;BAIXA;2022-08-04;13;12;1;5;N
JACOBINA;261;EPS;CORTE;2022-08-10;9;9;0;4;N
BOM JESUS DA LAPA;25;STC;CORTE;2022-08-09;11;10;1;3;N
GUANAMBI;142;STC;CORTE;2022-08-05;11;0;11;6;N
JEQUIE;278;EPS;CORTE;2022-08-05;16;0;16;6;N
EUNAPOLIS;87;EPS;CORTE;2022-08-22;7;6;1;2;N
ILHEUS;180;EPS;DISJUNTOR;2022-08-08;24;23;1;2;N
CAMACARI;50;EPS;DISJUNTOR;2022-08-24;40;38;2;4;N
VALENCA;486;EPS;CORTE;2022-08-11;7;7;0;5;N
JACOBINA;257;EPS;CORTE;2022-08-09;9;9;0;3;N
REMANSO;392;EPS;CORTE;2022-08-16;30;30;0;3;N
VALENCA;491;STC;RECORTE;2022-08-15;17;17;0;2;N
IBOTIRAMA;169;STC;CORTE;2022-08-16;9;9;0;3;N
PIRAJA;354;EPS;CORTE;2022-08-12;16;16;0;6;N
SENHOR DO BONFIM;451;STC;CORTE;2022-08-09;11;11;0;3;N
GUANAMBI;138;STC;CORTE;2022-08-04;11;11;0;5;N
CONCEICAO DO COITE;65;EPS;CORTE;2022-08-23;7;7;0;3;N
ILHEUS;179;STC;CORTE;2022-08-02;11;11;0;3;N
AMARGOSA;11;EPS;CORTE;2022-08-22;15;15;0;2;N
ITABUNA;236;STC;CORTE;2022-08-18;14;14;0;5;N
ITAPOAN;253;EPS;RECORTE;2022-08-03;18;14;4;4;N
GUANAMBI;150;EPS;CORTE;2022-08-18;6;5;1;5;N
GUANAMBI;138;STC;CORTE;2022-08-02;10;10;0;3;S
BARREIRAS;14;EPS;CORTE;2022-08-15;7;7;0;2;N
SERRINHA;463;EPS;CORTE;2022-08-10;10;10;0;4;N
JUAZEIRO;292;EPS;CORTE;2022-08-16;15;15;0;3;N
SEABRA;440;STC;CORTE;2022-08-08;6;5;1;2;N
JACOBINA;258;STC;CORTE;2022-08-11;16;15;1;5;N
CAMACARI;52;EPS;RECORTE;2022-08-18;12;12;0;5;N
FEIRA DE SANTANA NORTE;107;EPS;RECORTE;2022-08-24;8;8;0;4;N
JACOBINA;261;EPS;RECORTE;2022-08-11;7;7;0;5;N
SERRINHA;462;EPS;CORTE;2022-08-22;7;7;0;2;N
PORTO SEGURO;360;EPS;CORTE;2022-08-19;10;10;0;6;N
ITAPOAN;254;STC;RECORTE;2022-08-03;8;6;2;4;S
JACOBINA;261;STC;RECORTE;2022-08-23;9;8;1;3;S
PIRAJA;354;STC;CORTE;2022-08-24;76;76;0;4;S
ITABERABA;223;EPS;CORTE;2022-08-23;2;2;0;3;N
ILHEUS;177;EPS;CORTE;2022-08-12;16;16;0;6;N
SANTO AMARO;425;EPS;CORTE;2022-08-09;11;11;0;3;N
BARREIRAS;16;STC;CORTE;2022-08-05;15;0;15;6;N
GRACA;135;EPS;BAIXA;2022-08-22;39;0;39;2;N
ILHEUS;187;EPS;CORTE;2022-08-15;23;22;1;2;N
SERRINHA;463;EPS;RECORTE;2022-08-11;7;7;0;5;N
SANTO AMARO;421;STC;CORTE;2022-08-22;21;21;0;2;N
LAURO DE FREITAS;298;STC;CORTE;2022-08-09;16;14;2;3;N
SANTA MARIA DA VITORIA;411;STC;CORTE;2022-08-02;7;6;1;3;N
LAURO DE FREITAS;296;EPS;CORTE;2022-08-19;15;15;0;6;N
ITABUNA;229;STC;RECORTE;2022-08-04;15;13;2;5;S
IRECE;209;STC;RECORTE;2022-08-17;18;15;3;4;S
JUAZEIRO;289;EPS;CORTE;2022-08-03;11;11;0;4;N
VALENCA;497;STC;CORTE;2022-08-16;21;21;0;3;N
SENHOR DO BONFIM;445;EPS;CORTE;2022-08-18;10;10;0;5;N
JUAZEIRO;288;EPS;CORTE;2022-08-15;15;15;0;2;N
PITUBA;356;EPS;CORTE;2022-08-09;40;38;2;3;N
EUNAPOLIS;88;EPS;RECORTE;2022-08-11;4;4;0;5;N
JEQUIE;273;EPS;RECORTE;2022-08-17;9;7;2;4;N
ILHEUS;173;EPS;CORTE;2022-08-11;22;21;1;5;N
PITUBA;357;STC;CORTE;2022-08-11;19;19;0;5;N
ALAGOINHAS;3;EPS;CORTE;2022-08-08;12;10;2;2;N
VITORIA DA CONQUISTA;501;EPS;CORTE;2022-08-08;15;15;0;2;N
CANDEIAS;533;EPS;DISJUNTOR;2022-08-12;24;24;0;6;N
PIRAJA;350;EPS;CORTE;2022-08-11;16;16;0;5;N
BRUMADO;37;STC;CORTE;2022-08-12;11;11;0;6;N
CANDEIAS;58;EPS;DISJUNTOR;2022-08-23;30;28;2;3;N
ESPLANADA;78;EPS;BAIXA;2022-08-04;12;12;0;5;N
FEIRA DE SANTANA NORTE;107;EPS;BAIXA;2022-08-24;6;5;1;4;N
ILHEUS;178;STC;RECORTE;2022-08-15;21;20;1;2;N
CAMACARI;52;EPS;BAIXA;2022-08-18;5;4;1;5;N
PIRAJA;350;STC;CORTE;2022-08-25;17;16;1;5;N
ILHEUS;173;STC;CORTE;2022-08-25;21;21;0;5;N
PAULO AFONSO;345;EPS;CORTE;2022-08-23;7;7;0;3;N
PORTO SEGURO;370;EPS;CORTE;2022-08-22;9;9;0;2;N
IRECE;206;STC;CORTE;2022-08-05;11;0;11;6;N
PITUBA;359;EPS;DISJUNTOR;2022-08-05;14;0;14;6;N
JUAZEIRO;290;STC;CORTE;2022-08-05;4;0;4;6;N
RIBEIRA DO POMBAL;399;EPS;CORTE;2022-08-05;13;0;13;6;N
EUNAPOLIS;88;STC;RECORTE;2022-08-25;5;3;2;5;N
GRACA;131;EPS;BAIXA;2022-08-19;10;0;10;6;S
RIBEIRA DO POMBAL;409;EPS;CORTE;2022-08-08;14;14;0;2;N
TEIXEIRA DE FREITAS;475;EPS;CORTE;2022-08-08;14;14;0;2;N
ITAPOAN;254;EPS;CORTE;2022-08-15;19;19;0;2;N
VALENCA;497;EPS;RECORTE;2022-08-03;13;12;1;4;N
ILHEUS;187;STC;DISJUNTOR;2022-08-10;2;2;0;4;S
GUANAMBI;142;EPS;CORTE;2022-08-16;6;6;0;3;N
IRECE;201;STC;CORTE;2022-08-16;10;10;0;3;N
IBOTIRAMA;165;STC;RECORTE;2022-08-16;8;8;0;3;N
ESPLANADA;80;EPS;CORTE;2022-08-04;12;12;0;5;N
SANTO ANTONIO DE JESUS;429;STC;RECORTE;2022-08-19;19;14;5;6;S
REMANSO;393;EPS;BAIXA;2022-08-05;11;11;0;6;N
PITUBA;356;EPS;RECORTE;2022-08-10;11;11;0;4;N
JEQUIE;279;EPS;CORTE;2022-08-18;16;14;2;5;N
AMARGOSA;12;EPS;BAIXA;2022-08-11;10;10;0;5;N
SANTO AMARO;422;STC;RECORTE;2022-08-11;30;30;0;5;N
IRECE;205;STC;RECORTE;2022-08-16;15;12;3;3;S
SANTO AMARO;421;STC;RECORTE;2022-08-23;21;19;2;3;N
FEIRA DE SANTANA NORTE;108;STC;RECORTE;2022-08-03;2;1;1;4;N
TEIXEIRA DE FREITAS;479;STC;RECORTE;2022-08-24;17;17;0;4;N
ALAGOINHAS;3;STC;RECORTE;2022-08-23;16;15;1;3;N
JACOBINA;263;STC;CORTE;2022-08-25;15;15;0;5;N
EUNAPOLIS;93;EPS;CORTE;2022-08-24;59;54;5;4;N
SERRINHA;468;EPS;CORTE;2022-08-24;6;6;0;4;N
ILHEUS;182;EPS;CORTE;2022-08-24;6;6;0;4;S
ITAPETINGA;249;EPS;CORTE;2022-08-09;15;14;1;3;N
PAULO AFONSO;345;EPS;RECORTE;2022-08-24;2;2;0;4;N
LUIS EDUARDO MAGALHAES;318;STC;CORTE;2022-08-05;6;0;6;6;N
REMANSO;391;EPS;CORTE;2022-08-05;10;0;10;6;N
CANDEIAS;59;EPS;CORTE;2022-08-05;18;0;18;6;N
BRUMADO;45;EPS;CORTE;2022-08-25;4;0;4;5;N
VALENCA;491;EPS;CORTE;2022-08-25;22;0;22;5;N
SANTO ANTONIO DE JESUS;435;STC;CORTE;2022-08-22;19;19;0;2;N
GRACA;135;EPS;CORTE;2022-08-23;88;85;3;3;N
ITAPETINGA;245;EPS;CORTE;2022-08-08;15;13;2;2;N
IRECE;211;STC;CORTE;2022-08-19;21;20;1;6;N
VITORIA DA CONQUISTA;513;STC;RECORTE;2022-08-02;17;16;1;3;N
IBOTIRAMA;163;EPS;CORTE;2022-08-02;8;8;0;3;N
VITORIA DA CONQUISTA;506;EPS;CORTE;2022-08-22;10;8;2;2;N
GRACA;136;EPS;CORTE;2022-08-11;21;19;2;5;N
SENHOR DO BONFIM;452;STC;CORTE;2022-08-22;10;10;0;2;N
RIBEIRA DO POMBAL;406;STC;CORTE;2022-08-09;11;10;1;3;N
ESPLANADA;79;EPS;RECORTE;2022-08-17;10;10;0;4;N
SEABRA;442;STC;CORTE;2022-08-09;11;9;2;3;N
ITAPOAN;252;EPS;DISJUNTOR;2022-08-22;42;42;0;2;N
FEIRA DE SANTANA SUL;125;EPS;CORTE;2022-08-19;18;17;1;6;N
PERIPERI;347;EPS;DISJUNTOR;2022-08-04;30;28;2;5;N
JACOBINA;255;EPS;RECORTE;2022-08-11;7;7;0;5;N
ITAPOAN;252;STC;CORTE;2022-08-04;19;19;0;5;N
ITABUNA;229;EPS;CORTE;2022-08-16;13;11;2;3;N
ITAPETINGA;245;STC;CORTE;2022-08-22;9;9;0;2;N
RIBEIRA DO POMBAL;409;EPS;RECORTE;2022-08-09;24;21;3;3;N
ITAPOAN;251;STC;CORTE;2022-08-16;19;17;2;3;N
GUANAMBI;142;STC;DISJUNTOR;2022-08-11;30;30;0;5;S
IRECE;205;EPS;BAIXA;2022-08-04;7;6;1;5;N
SANTA MARIA DA VITORIA;416;STC;CORTE;2022-08-16;11;11;0;3;N
PORTO SEGURO;377;EPS;CORTE;2022-08-12;9;9;0;6;N
IRECE;201;STC;RECORTE;2022-08-17;21;9;12;4;N
CONCEICAO DO COITE;74;EPS;CORTE;2022-08-15;7;7;0;2;N
BOM JESUS DA LAPA;29;STC;CORTE;2022-08-12;11;11;0;6;N
PORTO SEGURO;371;EPS;BAIXA;2022-08-11;4;2;2;5;N
BOM JESUS DA LAPA;27;EPS;CORTE;2022-08-22;4;4;0;2;N
EUNAPOLIS;105;EPS;CORTE;2022-08-03;5;5;0;4;N
CONCEICAO DO COITE;64;STC;RECORTE;2022-08-25;10;5;5;5;S
VITORIA DA CONQUISTA;500;EPS;BAIXA;2022-08-19;17;0;17;6;S
SANTO AMARO;423;STC;CORTE;2022-08-23;21;20;1;3;N
EUNAPOLIS;101;STC;CORTE;2022-08-16;11;11;0;3;N
CAMACARI;52;EPS;CORTE;2022-08-19;21;20;1;6;N
PITUBA;359;STC;CORTE;2022-08-12;19;17;2;6;N
IRECE;207;STC;CORTE;2022-08-18;21;21;0;5;N
BRUMADO;40;EPS;DISJUNTOR;2022-08-19;9;9;0;6;N
CONCEICAO DO COITE;72;STC;CORTE;2022-08-04;11;11;0;5;N
IBOTIRAMA;159;STC;CORTE;2022-08-15;9;9;0;2;N
PITUBA;357;EPS;CORTE;2022-08-22;17;16;1;2;N
ITABERABA;215;STC;CORTE;2022-08-12;11;11;0;6;N
ITABUNA;225;EPS;CORTE;2022-08-15;14;13;1;2;N
PAULO AFONSO;327;STC;CORTE;2022-08-09;11;10;1;3;N
FEIRA DE SANTANA NORTE;113;EPS;RECORTE;2022-08-03;18;18;0;4;N
LUIS EDUARDO MAGALHAES;323;STC;CORTE;2022-08-19;21;20;1;6;N
SANTO ANTONIO DE JESUS;435;STC;DISJUNTOR;2022-08-03;20;20;0;4;S
VALENCA;491;EPS;CORTE;2022-08-02;20;20;0;3;N
FEIRA DE SANTANA NORTE;109;STC;CORTE;2022-08-15;20;19;1;2;N
BOM JESUS DA LAPA;24;STC;CORTE;2022-08-23;16;15;1;3;N
ITAPETINGA;245;STC;RECORTE;2022-08-23;13;12;1;3;N
JACOBINA;263;STC;CORTE;2022-08-02;16;16;0;3;N
PAULO AFONSO;325;EPS;CORTE;2022-08-19;8;8;0;6;N
VITORIA DA CONQUISTA;503;EPS;CORTE;2022-08-09;15;14;1;3;N
ITABUNA;227;STC;CORTE;2022-08-03;20;20;0;4;S
SANTO AMARO;424;STC;CORTE;2022-08-11;18;17;1;5;N
SANTA MARIA DA VITORIA;412;STC;CORTE;2022-08-15;11;11;0;2;N
VITORIA DA CONQUISTA;504;STC;CORTE;2022-08-11;11;11;0;5;N
LAURO DE FREITAS;294;EPS;RECORTE;2022-08-19;14;5;9;6;S
SANTO ANTONIO DE JESUS;430;EPS;CORTE;2022-08-19;4;4;0;6;N
GUANAMBI;142;EPS;BAIXA;2022-08-17;3;2;1;4;N
ESPLANADA;79;EPS;BAIXA;2022-08-17;6;6;0;4;N
BARREIRAS;18;EPS;CORTE;2022-08-18;7;5;2;5;N
LIVRAMENTO DE NOSSA SENHORA;306;STC;RECORTE;2022-08-11;2;1;1;5;S
TEIXEIRA DE FREITAS;481;EPS;CORTE;2022-08-10;10;10;0;4;N
BRUMADO;38;STC;CORTE;2022-08-25;10;10;0;5;N
CONCEICAO DO COITE;75;STC;RECORTE;2022-08-16;10;6;4;3;S
JACOBINA;260;EPS;CORTE;2022-08-24;4;4;0;4;N
JACOBINA;261;EPS;CORTE;2022-08-12;9;8;1;6;N
BOM JESUS DA LAPA;24;EPS;CORTE;2022-08-09;5;5;0;3;N
SANTO ANTONIO DE JESUS;432;STC;CORTE;2022-08-09;13;13;0;3;N
JUAZEIRO;284;STC;CORTE;2022-08-05;9;0;9;6;N
LUIS EDUARDO MAGALHAES;323;EPS;CORTE;2022-08-05;8;0;8;6;N
RIBEIRA DO POMBAL;408;EPS;BAIXA;2022-08-19;1;0;1;6;S
PIRAJA;355;EPS;CORTE;2022-08-02;23;23;0;3;N
REMANSO;392;EPS;CORTE;2022-08-18;30;28;2;5;N
LUIS EDUARDO MAGALHAES;319;STC;CORTE;2022-08-18;17;16;1;5;N
VALENCA;491;EPS;RECORTE;2022-08-03;26;26;0;4;N
VITORIA DA CONQUISTA;515;STC;CORTE;2022-08-02;11;10;1;3;N
TEIXEIRA DE FREITAS;477;STC;CORTE;2022-08-23;21;21;0;3;N
VITORIA DA CONQUISTA;499;STC;CORTE;2022-08-22;11;11;0;2;N
REMANSO;394;STC;CORTE;2022-08-08;9;9;0;2;N
SENHOR DO BONFIM;450;EPS;CORTE;2022-08-09;12;12;0;3;N
JACOBINA;256;EPS;CORTE;2022-08-23;8;8;0;3;N
SERRINHA;463;EPS;CORTE;2022-08-12;9;9;0;6;N
EUNAPOLIS;90;STC;CORTE;2022-08-02;11;10;1;3;N
ITAPOAN;250;STC;CORTE;2022-08-03;3;3;0;4;S
BARREIRAS;16;STC;CORTE;2022-08-05;15;15;0;6;S
LUIS EDUARDO MAGALHAES;318;EPS;CORTE;2022-08-16;7;7;0;3;N
ILHEUS;178;STC;CORTE;2022-08-16;21;21;0;3;N
VITORIA DA CONQUISTA;513;EPS;CORTE;2022-08-12;15;15;0;6;N
SEABRA;439;EPS;CORTE;2022-08-08;7;7;0;2;N
JACOBINA;260;EPS;RECORTE;2022-08-25;6;5;1;5;N
FEIRA DE SANTANA SUL;124;EPS;CORTE;2022-08-08;24;22;2;2;N
BARREIRAS;20;STC;RECORTE;2022-08-09;15;11;4;3;N
JACOBINA;263;STC;RECORTE;2022-08-03;3;3;0;4;N
ALAGOINHAS;1;STC;CORTE;2022-08-22;2;2;0;2;N
JACOBINA;257;STC;CORTE;2022-08-25;16;16;0;5;N
EUNAPOLIS;88;EPS;CORTE;2022-08-12;6;6;0;6;N
TEIXEIRA DE FREITAS;479;EPS;DISJUNTOR;2022-08-17;6;6;0;4;N
TEIXEIRA DE FREITAS;469;EPS;CORTE;2022-08-08;9;9;0;2;N
ITABERABA;224;STC;CORTE;2022-08-25;13;13;0;5;S
ITABUNA;185;EPS;CORTE;2022-08-05;20;0;20;6;N
GRACA;132;STC;RECORTE;2022-08-25;20;11;9;5;N
SENHOR DO BONFIM;446;EPS;CORTE;2022-08-08;16;15;1;2;N
SENHOR DO BONFIM;446;STC;CORTE;2022-08-22;11;11;0;2;N
ESPLANADA;83;EPS;CORTE;2022-08-19;12;11;1;6;N
PIRAJA;353;EPS;DISJUNTOR;2022-08-09;26;24;2;3;N
SANTO AMARO;420;EPS;CORTE;2022-08-22;10;9;1;2;N
ITABUNA;232;STC;CORTE;2022-08-19;18;17;1;6;N
POSTO DA MATA;385;EPS;CORTE;2022-08-11;14;13;1;5;N
SEABRA;436;STC;CORTE;2022-08-09;11;11;0;3;N
SENHOR DO BONFIM;450;EPS;RECORTE;2022-08-10;6;6;0;4;N
IBOTIRAMA;164;EPS;CORTE;2022-08-15;7;6;1;2;N
PAULO AFONSO;332;EPS;CORTE;2022-08-09;8;8;0;3;N
VALENCA;497;STC;CORTE;2022-08-16;20;20;0;3;S
PORTO SEGURO;373;STC;CORTE;2022-08-02;21;19;2;3;N
REMANSO;389;STC;CORTE;2022-08-17;35;35;0;4;S
SERRINHA;458;EPS;CORTE;2022-08-23;14;14;0;3;N
PAULO AFONSO;333;STC;CORTE;2022-08-11;11;11;0;5;N
PERIPERI;347;STC;CORTE;2022-08-11;16;15;1;5;N
PITUBA;356;EPS;CORTE;2022-08-11;40;37;3;5;N
JUAZEIRO;289;STC;CORTE;2022-08-19;9;9;0;6;N
IRECE;205;STC;CORTE;2022-08-19;21;20;1;6;N
EUNAPOLIS;87;EPS;RECORTE;2022-08-25;3;2;1;5;N
ILHEUS;178;EPS;RECORTE;2022-08-03;10;10;0;4;N
IRECE;199;EPS;BAIXA;2022-08-04;7;6;1;5;N
ITABUNA;226;EPS;BAIXA;2022-08-04;5;5;0;5;N
ILHEUS;178;STC;RECORTE;2022-08-17;21;15;6;4;N
BARREIRAS;16;STC;RECORTE;2022-08-08;15;14;1;2;N
ITAPOAN;250;STC;RECORTE;2022-08-04;10;2;8;5;S
CAMACARI;50;STC;RECORTE;2022-08-09;16;10;6;3;N
ITABERABA;222;STC;CORTE;2022-08-02;6;6;0;3;N
VITORIA DA CONQUISTA;509;STC;CORTE;2022-08-25;11;10;1;5;N
SERRINHA;459;STC;CORTE;2022-08-25;11;11;0;5;N
LIVRAMENTO DE NOSSA SENHORA;306;EPS;CORTE;2022-08-23;9;9;0;3;N
JUAZEIRO;288;EPS;CORTE;2022-08-17;7;7;0;4;N
VITORIA DA CONQUISTA;525;STC;CORTE;2022-08-05;10;0;10;6;N
FEIRA DE SANTANA NORTE;116;STC;CORTE;2022-08-05;11;0;11;6;N
IBOTIRAMA;166;STC;CORTE;2022-08-05;6;0;6;6;N
IRECE;205;EPS;CORTE;2022-08-05;13;0;13;6;N
SANTO AMARO;422;EPS;BAIXA;2022-08-22;19;0;19;2;N
IRECE;201;STC;CORTE;2022-08-18;11;11;0;5;N
VALENCA;492;EPS;CORTE;2022-08-15;14;13;1;2;N
FEIRA DE SANTANA NORTE;107;EPS;RECORTE;2022-08-03;54;53;1;4;N
CONCEICAO DO COITE;65;EPS;CORTE;2022-08-02;6;6;0;3;N
JACOBINA;264;STC;CORTE;2022-08-15;10;10;0;2;N
JUAZEIRO;284;EPS;CORTE;2022-08-16;15;15;0;3;N
JUAZEIRO;285;STC;CORTE;2022-08-18;9;9;0;5;N
IBOTIRAMA;161;STC;CORTE;2022-08-16;9;9;0;3;N
PIRAJA;352;STC;RECORTE;2022-08-04;17;12;5;5;N
BARREIRAS;20;EPS;CORTE;2022-08-19;7;7;0;6;N
BARREIRAS;22;STC;CORTE;2022-08-09;13;13;0;3;N
VITORIA DA CONQUISTA;520;STC;CORTE;2022-08-16;11;10;1;3;N
GUANAMBI;142;EPS;CORTE;2022-08-18;6;6;0;5;N
EUNAPOLIS;99;EPS;RECORTE;2022-08-04;5;4;1;5;N
PAULO AFONSO;344;STC;CORTE;2022-08-02;10;10;0;3;N
JUAZEIRO;290;STC;RECORTE;2022-08-08;16;14;2;2;N
TEIXEIRA DE FREITAS;474;EPS;CORTE;2022-08-22;10;9;1;2;N
ALAGOINHAS;3;STC;RECORTE;2022-08-23;10;7;3;3;S
SANTO ANTONIO DE JESUS;426;STC;CORTE;2022-08-09;13;13;0;3;N
FEIRA DE SANTANA NORTE;115;STC;RECORTE;2022-08-18;21;18;3;5;N
LAURO DE FREITAS;295;EPS;DISJUNTOR;2022-08-16;7;7;0;3;N
LUIS EDUARDO MAGALHAES;317;EPS;CORTE;2022-08-05;8;0;8;6;N
ITABUNA;231;STC;CORTE;2022-08-08;16;14;2;2;N
SEABRA;441;STC;CORTE;2022-08-23;20;16;4;3;N
ITAPOAN;250;EPS;CORTE;2022-08-16;57;51;6;3;N
EUNAPOLIS;91;STC;CORTE;2022-08-15;11;11;0;2;N
ITAPOAN;251;EPS;CORTE;2022-08-04;46;41;5;5;N
FEIRA DE SANTANA SUL;127;STC;CORTE;2022-08-11;17;17;0;5;N
ITAPETINGA;245;STC;CORTE;2022-08-22;36;33;3;2;S
SENHOR DO BONFIM;453;STC;CORTE;2022-08-12;13;12;1;6;N
RIBEIRA DO POMBAL;409;EPS;RECORTE;2022-08-11;9;9;0;5;N
ILHEUS;179;EPS;CORTE;2022-08-15;23;23;0;2;N
CANDEIAS;58;EPS;DISJUNTOR;2022-08-02;5;5;0;3;N
TEIXEIRA DE FREITAS;471;STC;CORTE;2022-08-23;19;19;0;3;N
LAURO DE FREITAS;293;STC;RECORTE;2022-08-23;32;22;10;3;N
SANTO ANTONIO DE JESUS;434;EPS;CORTE;2022-08-22;8;8;0;2;N
LUIS EDUARDO MAGALHAES;313;EPS;CORTE;2022-08-04;8;8;0;5;N
SENHOR DO BONFIM;451;EPS;CORTE;2022-08-22;10;10;0;2;N
VITORIA DA CONQUISTA;507;EPS;CORTE;2022-08-12;15;15;0;6;N
RIBEIRA DO POMBAL;405;EPS;CORTE;2022-08-09;11;11;0;3;N
BRUMADO;43;STC;CORTE;2022-08-16;11;9;2;3;N
SANTA MARIA DA VITORIA;416;STC;CORTE;2022-08-18;15;15;0;5;N
PORTO SEGURO;366;EPS;RECORTE;2022-08-24;16;15;1;4;N
EUNAPOLIS;99;EPS;BAIXA;2022-08-04;4;4;0;5;N
SANTO AMARO;421;EPS;BAIXA;2022-08-11;36;25;11;5;N
ITAPETINGA;244;EPS;CORTE;2022-08-22;9;9;0;2;N
PORTO SEGURO;369;STC;RECORTE;2022-08-02;16;16;0;3;N
PAULO AFONSO;338;EPS;CORTE;2022-08-11;7;7;0;5;N
BOM JESUS DA LAPA;28;EPS;CORTE;2022-08-12;5;4;1;6;N
SEABRA;441;EPS;CORTE;2022-08-09;5;5;0;3;N
EUNAPOLIS;105;EPS;CORTE;2022-08-05;11;0;11;6;N
CONCEICAO DO COITE;75;EPS;CORTE;2022-08-05;9;0;9;6;N
ITAPOAN;250;EPS;RECORTE;2022-08-17;57;55;2;4;N
FEIRA DE SANTANA NORTE;108;EPS;CORTE;2022-08-15;21;19;2;2;N
JACOBINA;263;STC;CORTE;2022-08-04;18;18;0;5;N
SEABRA;440;STC;DISJUNTOR;2022-08-16;20;20;0;3;S
CAMACARI;53;EPS;CORTE;2022-08-09;18;16;2;3;N
SANTO ANTONIO DE JESUS;8;STC;CORTE;2022-08-23;16;15;1;3;N
SEABRA;437;STC;CORTE;2022-08-22;21;17;4;2;N
FEIRA DE SANTANA SUL;122;STC;CORTE;2022-08-22;23;23;0;2;N
BRUMADO;39;STC;CORTE;2022-08-15;11;11;0;2;N
JACOBINA;262;EPS;CORTE;2022-08-02;9;9;0;3;N
PAULO AFONSO;403;EPS;RECORTE;2022-08-17;9;9;0;4;N
SERRINHA;468;EPS;CORTE;2022-08-03;4;4;0;4;N
ITABERABA;214;EPS;CORTE;2022-08-12;5;5;0;6;N
GRACA;132;EPS;CORTE;2022-08-12;42;42;0;6;N
ALAGOINHAS;4;EPS;CORTE;2022-08-23;18;15;3;3;N
SANTO ANTONIO DE JESUS;8;EPS;CORTE;2022-08-09;5;5;0;3;N
SANTO AMARO;422;EPS;CORTE;2022-08-23;20;20;0;3;N
POSTO DA MATA;379;EPS;CORTE;2022-08-11;7;7;0;5;N
EUNAPOLIS;101;STC;CORTE;2022-08-18;11;11;0;5;N
ITAPETINGA;245;EPS;RECORTE;2022-08-11;9;9;0;5;N
SANTO ANTONIO DE JESUS;9;STC;CORTE;2022-08-11;13;13;0;5;N
ITABUNA;226;STC;CORTE;2022-08-19;16;16;0;6;N
ILHEUS;180;STC;RECORTE;2022-08-18;21;21;0;5;N
SANTA MARIA DA VITORIA;412;STC;CORTE;2022-08-17;1;1;0;4;N
FEIRA DE SANTANA NORTE;112;EPS;RECORTE;2022-08-17;3;3;0;4;N
POSTO DA MATA;383;EPS;RECORTE;2022-08-11;10;4;6;5;S
ITABERABA;217;EPS;RECORTE;2022-08-24;10;10;0;4;S
ITABUNA;231;STC;RECORTE;2022-08-09;16;6;10;3;N
BOM JESUS DA LAPA;23;EPS;CORTE;2022-08-23;4;4;0;3;N
BRUMADO;47;EPS;BAIXA;2022-08-04;4;3;1;5;N
VALENCA;493;EPS;BAIXA;2022-08-04;17;9;8;5;N
PIRAJA;354;EPS;DISJUNTOR;2022-08-22;46;46;0;2;N
LUIS EDUARDO MAGALHAES;313;STC;RECORTE;2022-08-17;8;7;1;4;S
SANTO AMARO;423;STC;CORTE;2022-08-25;21;20;1;5;N
VITORIA DA CONQUISTA;503;STC;CORTE;2022-08-25;11;10;1;5;N
BOM JESUS DA LAPA;24;STC;CORTE;2022-08-25;14;14;0;5;N
TEIXEIRA DE FREITAS;480;EPS;CORTE;2022-08-24;9;9;0;4;N
SANTO ANTONIO DE JESUS;431;EPS;CORTE;2022-08-09;5;5;0;3;N
PAULO AFONSO;401;STC;CORTE;2022-08-05;11;0;11;6;N
IBOTIRAMA;160;STC;CORTE;2022-08-05;6;0;6;6;N
SEABRA;441;STC;RECORTE;2022-08-24;21;18;3;4;N
FEIRA DE SANTANA SUL;126;STC;RECORTE;2022-08-24;1;0;1;4;N
PORTO SEGURO;372;EPS;CORTE;2022-08-25;8;0;8;5;N
BRUMADO;37;EPS;CORTE;2022-08-25;4;0;4;5;N
JACOBINA;258;STC;CORTE;2022-08-15;16;16;0;2;N
REMANSO;393;EPS;CORTE;2022-08-08;54;53;1;2;N
PIRAJA;354;EPS;CORTE;2022-08-16;30;28;2;3;N
PIRAJA;355;EPS;CORTE;2022-08-04;42;39;3;5;N
ALAGOINHAS;2;STC;CORTE;2022-08-12;23;22;1;6;N
TEIXEIRA DE FREITAS;480;EPS;RECORTE;2022-08-25;25;21;4;5;N
VITORIA DA CONQUISTA;518;EPS;RECORTE;2022-08-04;16;15;1;5;N
IBOTIRAMA;159;EPS;RECORTE;2022-08-04;7;7;0;5;N
LIVRAMENTO DE NOSSA SENHORA;312;STC;CORTE;2022-08-16;7;7;0;3;N
IRECE;195;STC;CORTE;2022-08-16;18;15;3;3;S
JEQUIE;274;EPS;CORTE;2022-08-08;14;12;2;2;N
SANTO ANTONIO DE JESUS;427;STC;CORTE;2022-08-22;16;16;0;2;N
IBOTIRAMA;155;EPS;CORTE;2022-08-02;8;8;0;3;N
VITORIA DA CONQUISTA;500;STC;CORTE;2022-08-12;11;11;0;6;N
SERRINHA;468;EPS;RECORTE;2022-08-04;7;7;0;5;N
GUANAMBI;138;STC;CORTE;2022-08-08;11;10;1;2;N
FEIRA DE SANTANA NORTE;106;STC;CORTE;2022-08-04;20;20;0;5;N
IBOTIRAMA;156;STC;CORTE;2022-08-04;8;8;0;5;N
ITAPOAN;250;EPS;BAIXA;2022-08-17;17;9;8;4;N
BOM JESUS DA LAPA;23;EPS;RECORTE;2022-08-24;10;10;0;4;N
SENHOR DO BONFIM;450;EPS;CORTE;2022-08-11;6;6;0;5;N
IRECE;195;EPS;CORTE;2022-08-04;13;12;1;5;N
LUIS EDUARDO MAGALHAES;320;STC;CORTE;2022-08-08;11;10;1;2;N
SANTO ANTONIO DE JESUS;431;EPS;RECORTE;2022-08-10;6;6;0;4;N
BRUMADO;49;STC;CORTE;2022-08-18;11;11;0;5;N
VALENCA;486;EPS;CORTE;2022-08-15;6;6;0;2;N
LIVRAMENTO DE NOSSA SENHORA;312;EPS;CORTE;2022-08-02;6;4;2;3;N
ALAGOINHAS;4;EPS;RECORTE;2022-08-24;19;17;2;4;N
POSTO DA MATA;378;EPS;RECORTE;2022-08-24;10;7;3;4;N
BARREIRAS;16;STC;CORTE;2022-08-09;15;15;0;3;N
RIBEIRA DO POMBAL;404;EPS;BAIXA;2022-08-22;12;8;4;2;N
SANTO AMARO;421;EPS;DISJUNTOR;2022-08-18;4;4;0;5;N
LUIS EDUARDO MAGALHAES;318;EPS;CORTE;2022-08-18;7;7;0;5;N
PORTO SEGURO;376;EPS;BAIXA;2022-08-25;14;9;5;5;S
ITABUNA;226;STC;RECORTE;2022-08-18;11;6;5;5;S
IBOTIRAMA;159;STC;RECORTE;2022-08-16;12;11;1;3;S
IBOTIRAMA;155;STC;CORTE;2022-08-16;9;9;0;3;N
ITABERABA;224;EPS;CORTE;2022-08-15;4;4;0;2;N
TEIXEIRA DE FREITAS;482;STC;RECORTE;2022-08-15;17;15;2;2;N
TEIXEIRA DE FREITAS;477;STC;CORTE;2022-08-25;21;21;0;5;N
TEIXEIRA DE FREITAS;476;EPS;CORTE;2022-08-23;16;14;2;3;N
PORTO SEGURO;360;EPS;CORTE;2022-08-23;9;9;0;3;N
PORTO SEGURO;361;EPS;CORTE;2022-08-11;9;8;1;5;N
ILHEUS;177;EPS;CORTE;2022-08-16;13;13;0;3;N
ILHEUS;178;EPS;CORTE;2022-08-04;12;0;12;5;N
POSTO DA MATA;388;EPS;CORTE;2022-08-24;3;3;0;4;S
SANTA MARIA DA VITORIA;412;STC;RECORTE;2022-08-18;2;2;0;5;N
FEIRA DE SANTANA NORTE;120;STC;CORTE;2022-08-08;1;1;0;2;N
IRECE;204;EPS;CORTE;2022-08-19;16;15;1;6;N
IRECE;206;STC;CORTE;2022-08-09;11;11;0;3;N
CANDEIAS;58;STC;CORTE;2022-08-09;26;25;1;3;N
FEIRA DE SANTANA NORTE;109;EPS;BAIXA;2022-08-04;16;16;0;5;N
VITORIA DA CONQUISTA;524;STC;CORTE;2022-08-19;11;11;0;6;N
ITABUNA;233;STC;CORTE;2022-08-09;32;31;1;3;N
JACOBINA;255;STC;CORTE;2022-08-02;18;17;1;3;N
JEQUIE;269;EPS;CORTE;2022-08-19;8;7;1;6;N
ILHEUS;173;EPS;CORTE;2022-08-15;23;22;1;2;N
LAURO DE FREITAS;296;EPS;CORTE;2022-08-23;14;14;0;3;N
ITABUNA;231;EPS;CORTE;2022-08-19;15;14;1;6;N
IBOTIRAMA;165;STC;CORTE;2022-08-19;16;14;2;6;N
BOM JESUS DA LAPA;31;STC;CORTE;2022-08-15;11;11;0;2;N
SENHOR DO BONFIM;447;STC;CORTE;2022-08-12;13;12;1;6;N
PIRAJA;350;EPS;CORTE;2022-08-15;16;16;0;2;N
JUAZEIRO;288;EPS;CORTE;2022-08-19;7;7;0;6;N
SANTO AMARO;421;EPS;CORTE;2022-08-12;11;11;0;6;N
CONCEICAO DO COITE;65;EPS;DISJUNTOR;2022-08-10;2;2;0;4;N
SANTA MARIA DA VITORIA;418;STC;CORTE;2022-08-19;14;13;1;6;N
POSTO DA MATA;386;STC;CORTE;2022-08-15;7;6;1;2;N
FEIRA DE SANTANA NORTE;115;STC;CORTE;2022-08-19;10;10;0;6;N
ESPLANADA;84;EPS;CORTE;2022-08-09;15;13;2;3;N
SENHOR DO BONFIM;445;EPS;CORTE;2022-08-22;10;10;0;2;N
BOM JESUS DA LAPA;23;EPS;BAIXA;2022-08-24;3;2;1;4;N
ALAGOINHAS;4;EPS;BAIXA;2022-08-24;5;4;1;4;N
IBOTIRAMA;158;EPS;BAIXA;2022-08-16;8;8;0;3;N
FEIRA DE SANTANA SUL;124;EPS;RECORTE;2022-08-11;40;39;1;5;N
IBOTIRAMA;159;EPS;BAIXA;2022-08-04;7;6;1;5;N
ILHEUS;178;STC;RECORTE;2022-08-19;21;13;8;6;N
ITAPETINGA;247;STC;CORTE;2022-08-25;9;9;0;5;N
PAULO AFONSO;332;EPS;CORTE;2022-08-11;8;8;0;5;N
IRECE;192;STC;CORTE;2022-08-05;10;0;10;6;N
JUAZEIRO;290;STC;CORTE;2022-08-09;1;1;0;3;N
ALAGOINHAS;1;STC;RECORTE;2022-08-25;32;22;10;5;N
BARREIRAS;21;STC;CORTE;2022-08-23;21;17;4;3;N
PAULO AFONSO;329;STC;CORTE;2022-08-12;11;11;0;6;N
JUAZEIRO;286;STC;CORTE;2022-08-08;9;9;0;2;N
IBOTIRAMA;161;STC;CORTE;2022-08-18;16;16;0;5;N
GRACA;135;STC;CORTE;2022-08-15;17;17;0;2;N
IRECE;202;STC;CORTE;2022-08-08;11;10;1;2;N
CAMACARI;56;STC;CORTE;2022-08-12;16;16;0;6;N
PERIPERI;348;STC;RECORTE;2022-08-02;57;53;4;3;N
ITABERABA;217;STC;CORTE;2022-08-15;22;22;0;2;N
VITORIA DA CONQUISTA;519;EPS;CORTE;2022-08-16;15;14;1;3;N
CONCEICAO DO COITE;73;STC;CORTE;2022-08-19;11;11;0;6;N
LAURO DE FREITAS;294;STC;CORTE;2022-08-12;16;16;0;6;N
ITAPETINGA;239;EPS;RECORTE;2022-08-11;9;7;2;5;N
LAURO DE FREITAS;293;EPS;CORTE;2022-08-10;17;14;3;4;N
JUAZEIRO;290;STC;RECORTE;2022-08-10;16;14;2;4;N
CANDEIAS;58;STC;RECORTE;2022-08-10;16;13;3;4;N
POSTO DA MATA;383;STC;CORTE;2022-08-02;6;6;0;3;N
CONCEICAO DO COITE;67;EPS;BAIXA;2022-08-04;5;3;2;5;N
TEIXEIRA DE FREITAS;475;EPS;CORTE;2022-08-12;10;10;0;6;N
PIRAJA;351;STC;RECORTE;2022-08-16;6;4;2;3;S
VITORIA DA CONQUISTA;521;EPS;DISJUNTOR;2022-08-24;31;27;4;4;N
ILHEUS;183;EPS;CORTE;2022-08-18;24;22;2;5;N
JACOBINA;263;EPS;CORTE;2022-08-15;9;9;0;2;N
VALENCA;487;EPS;BAIXA;2022-08-04;18;5;13;5;N
PIRAJA;355;EPS;BAIXA;2022-08-05;1;1;0;6;N
BRUMADO;47;EPS;CORTE;2022-08-05;5;0;5;6;N
VALENCA;493;EPS;CORTE;2022-08-05;8;0;8;6;N
ITABERABA;215;EPS;CORTE;2022-08-25;3;0;3;5;N
PORTO SEGURO;366;EPS;CORTE;2022-08-25;7;0;7;5;N
IRECE;211;STC;CORTE;2022-08-23;21;20;1;3;N
ILHEUS;180;EPS;CORTE;2022-08-05;44;42;2;6;N
SENHOR DO BONFIM;453;STC;CORTE;2022-08-12;15;15;0;6;S
ITAPETINGA;247;STC;CORTE;2022-08-02;9;9;0;3;N
ESPLANADA;77;STC;CORTE;2022-08-09;11;11;0;3;N
PAULO AFONSO;324;STC;CORTE;2022-08-23;16;14;2;3;N
IPIAU;188;EPS;CORTE;2022-08-19;8;8;0;6;N
SENHOR DO BONFIM;452;EPS;CORTE;2022-08-12;12;11;1;6;N
TEIXEIRA DE FREITAS;485;EPS;CORTE;2022-08-15;10;10;0;2;N
ITAPETINGA;245;EPS;CORTE;2022-08-12;12;12;0;6;N
IBOTIRAMA;170;EPS;CORTE;2022-08-19;6;6;0;6;N
ITAPOAN;252;STC;CORTE;2022-08-08;19;17;2;2;N
VITORIA DA CONQUISTA;508;EPS;CORTE;2022-08-02;15;14;1;3;N
FEIRA DE SANTANA SUL;125;EPS;CORTE;2022-08-23;18;18;0;3;N
JEQUIE;277;STC;CORTE;2022-08-11;11;11;0;5;N
GUANAMBI;138;EPS;CORTE;2022-08-19;6;6;0;6;N
VITORIA DA CONQUISTA;509;STC;CORTE;2022-08-04;11;11;0;5;N
GRACA;137;EPS;BAIXA;2022-08-25;9;7;2;5;S
IRECE;197;STC;CORTE;2022-08-19;21;21;0;6;N
SEABRA;440;EPS;CORTE;2022-08-23;10;9;1;3;N
SEABRA;441;EPS;CORTE;2022-08-11;5;5;0;5;N
FEIRA DE SANTANA SUL;126;STC;CORTE;2022-08-25;1;1;0;5;N
SEABRA;441;STC;CORTE;2022-08-25;17;15;2;5;N
TEIXEIRA DE FREITAS;471;STC;CORTE;2022-08-25;19;19;0;5;N
TEIXEIRA DE FREITAS;470;EPS;CORTE;2022-08-23;14;13;1;3;N
IRECE;211;EPS;CORTE;2022-08-09;14;13;1;3;N
PAULO AFONSO;325;STC;CORTE;2022-08-11;11;10;1;5;N
SERRINHA;467;STC;CORTE;2022-08-05;22;0;22;6;N
PORTO SEGURO;377;EPS;CORTE;2022-08-16;9;9;0;3;N
LAURO DE FREITAS;293;STC;RECORTE;2022-08-25;16;12;4;5;N
EUNAPOLIS;88;EPS;DISJUNTOR;2022-08-22;4;4;0;2;N
GRACA;133;STC;CORTE;2022-08-16;17;15;2;3;N
SANTO ANTONIO DE JESUS;431;EPS;CORTE;2022-08-11;5;5;0;5;N
VITORIA DA CONQUISTA;504;STC;CORTE;2022-08-15;11;9;2;2;N
PITUBA;359;EPS;CORTE;2022-08-02;27;26;1;3;N
GRACA;133;EPS;CORTE;2022-08-02;25;24;1;3;N
IRECE;207;STC;CORTE;2022-08-22;20;20;0;2;N
IRECE;207;EPS;CORTE;2022-08-08;13;12;1;2;N
SANTA MARIA DA VITORIA;412;STC;CORTE;2022-08-19;16;15;1;6;N
FEIRA DE SANTANA NORTE;108;EPS;CORTE;2022-08-17;45;45;0;4;N
PITUBA;359;STC;CORTE;2022-08-16;19;19;0;3;N
GRACA;134;STC;CORTE;2022-08-04;34;31;3;5;N
RIBEIRA DO POMBAL;400;EPS;CORTE;2022-08-22;10;10;0;2;N
PAULO AFONSO;339;STC;RECORTE;2022-08-16;10;8;2;3;N
BRUMADO;38;EPS;CORTE;2022-08-15;8;8;0;2;N
SANTO AMARO;424;STC;CORTE;2022-08-15;9;9;0;2;N
ITABUNA;227;STC;CORTE;2022-08-09;16;16;0;3;N
ITAPOAN;250;EPS;RECORTE;2022-08-19;30;27;3;6;N
ITABUNA;225;EPS;CORTE;2022-08-19;8;7;1;6;N
GRACA;137;STC;RECORTE;2022-08-16;8;4;4;3;S
IRECE;211;EPS;RECORTE;2022-08-10;8;8;0;4;N
PORTO SEGURO;373;EPS;CORTE;2022-08-15;9;9;0;2;N
IRECE;211;STC;RECORTE;2022-08-24;21;20;1;4;N
VITORIA DA CONQUISTA;519;EPS;BAIXA;2022-08-17;12;11;1;4;N
PORTO SEGURO;377;EPS;RECORTE;2022-08-17;17;17;0;4;N
FEIRA DE SANTANA SUL;121;EPS;CORTE;2022-08-22;5;5;0;2;N
TEIXEIRA DE FREITAS;482;EPS;CORTE;2022-08-02;11;10;1;3;N
ILHEUS;180;STC;RECORTE;2022-08-18;15;8;7;5;S
LUIS EDUARDO MAGALHAES;323;EPS;CORTE;2022-08-09;7;7;0;3;N
SANTA MARIA DA VITORIA;417;STC;RECORTE;2022-08-09;11;10;1;3;N
EUNAPOLIS;89;EPS;DISJUNTOR;2022-08-10;5;5;0;4;N
JACOBINA;264;EPS;BAIXA;2022-08-04;5;5;0;5;N
ITAPETINGA;241;STC;CORTE;2022-08-25;8;8;0;5;N
GUANAMBI;148;EPS;CORTE;2022-08-22;5;5;0;2;N
SANTO ANTONIO DE JESUS;8;EPS;CORTE;2022-08-11;5;4;1;5;N
FEIRA DE SANTANA NORTE;109;EPS;CORTE;2022-08-05;54;0;54;6;N
SANTA MARIA DA VITORIA;412;EPS;CORTE;2022-08-05;8;0;8;6;N
VITORIA DA CONQUISTA;518;EPS;CORTE;2022-08-05;19;0;19;6;N
SANTO AMARO;422;EPS;CORTE;2022-08-25;30;0;30;5;N
BOM JESUS DA LAPA;23;EPS;CORTE;2022-08-25;8;0;8;5;N
ALAGOINHAS;3;STC;CORTE;2022-08-02;23;22;1;3;N
TEIXEIRA DE FREITAS;480;EPS;DISJUNTOR;2022-08-09;18;18;0;3;N
ESPLANADA;83;STC;CORTE;2022-08-11;11;11;0;5;N
ITABERABA;215;EPS;RECORTE;2022-08-03;5;5;0;4;N
LUIS EDUARDO MAGALHAES;319;EPS;CORTE;2022-08-08;8;6;2;2;N
REMANSO;394;STC;CORTE;2022-08-12;9;9;0;6;N
PITUBA;357;EPS;DISJUNTOR;2022-08-09;13;12;1;3;N
LUIS EDUARDO MAGALHAES;319;STC;CORTE;2022-08-22;13;13;0;2;N
REMANSO;392;EPS;CORTE;2022-08-22;14;13;1;2;N
ALAGOINHAS;1;EPS;CORTE;2022-08-12;30;29;1;6;N
SANTO AMARO;424;STC;RECORTE;2022-08-16;13;13;0;3;N
GRACA;133;EPS;RECORTE;2022-08-03;19;18;1;4;N
RIBEIRA DO POMBAL;400;EPS;RECORTE;2022-08-23;18;18;0;3;N
ITABUNA;185;EPS;CORTE;2022-08-09;31;27;4;3;N
LUIS EDUARDO MAGALHAES;323;EPS;RECORTE;2022-08-10;7;7;0;4;N
JACOBINA;258;EPS;CORTE;2022-08-03;7;7;0;4;N
ITAPETINGA;238;STC;CORTE;2022-08-12;9;9;0;6;N
SANTO ANTONIO DE JESUS;426;EPS;CORTE;2022-08-22;4;4;0;2;N
SERRINHA;463;EPS;CORTE;2022-08-16;7;7;0;3;N
CONCEICAO DO COITE;66;EPS;CORTE;2022-08-17;7;7;0;4;N
RIBEIRA DO POMBAL;397;STC;CORTE;2022-08-23;11;11;0;3;N
PORTO SEGURO;366;EPS;RECORTE;2022-08-03;17;17;0;4;N
CAMACARI;52;EPS;RECORTE;2022-08-24;11;11;0;4;N
CONCEICAO DO COITE;72;STC;RECORTE;2022-08-09;11;8;3;3;N
IPIAU;530;EPS;CORTE;2022-08-11;8;7;1;5;N
LIVRAMENTO DE NOSSA SENHORA;311;EPS;CORTE;2022-08-16;6;5;1;3;N
IRECE;211;EPS;BAIXA;2022-08-10;2;2;0;4;N
JACOBINA;257;EPS;CORTE;2022-08-15;9;9;0;2;N
ITABERABA;215;STC;RECORTE;2022-08-17;21;19;2;4;N
FEIRA DE SANTANA NORTE;109;STC;RECORTE;2022-08-18;15;12;3;5;S
BRUMADO;48;EPS;CORTE;2022-08-18;7;7;0;5;N
FEIRA DE SANTANA NORTE;110;STC;RECORTE;2022-08-08;11;10;1;2;N
SANTO AMARO;422;EPS;DISJUNTOR;2022-08-08;3;2;1;2;N
JACOBINA;259;STC;CORTE;2022-08-05;6;0;6;6;N
VALENCA;487;EPS;CORTE;2022-08-05;8;0;8;6;N
CONCEICAO DO COITE;67;EPS;CORTE;2022-08-05;9;0;9;6;N
SENHOR DO BONFIM;446;EPS;CORTE;2022-08-12;12;11;1;6;N
JACOBINA;255;STC;CORTE;2022-08-04;16;16;0;5;N
REMANSO;390;STC;CORTE;2022-08-11;18;18;0;5;N
JUAZEIRO;289;EPS;CORTE;2022-08-09;15;14;1;3;N
SANTO AMARO;422;EPS;CORTE;2022-08-02;30;26;4;3;N
BOM JESUS DA LAPA;30;EPS;CORTE;2022-08-15;5;5;0;2;N
JACOBINA;258;EPS;RECORTE;2022-08-04;9;9;0;5;N
ITAPETINGA;248;STC;CORTE;2022-08-15;9;9;0;2;N
ALAGOINHAS;2;STC;RECORTE;2022-08-15;9;7;2;2;N
BARREIRAS;16;STC;RECORTE;2022-08-12;15;13;2;6;N
SERRINHA;459;EPS;CORTE;2022-08-15;12;12;0;2;N
EUNAPOLIS;88;EPS;RECORTE;2022-08-17;3;3;0;4;N
IPIAU;532;STC;RECORTE;2022-08-02;16;15;1;3;N
POSTO DA MATA;385;EPS;CORTE;2022-08-15;14;14;0;2;N
VITORIA DA CONQUISTA;523;EPS;CORTE;2022-08-19;14;14;0;6;N
ITABUNA;233;STC;CORTE;2022-08-11;16;16;0;5;N
REMANSO;389;STC;CORTE;2022-08-23;13;13;0;3;N
JEQUIE;271;STC;CORTE;2022-08-11;11;11;0;5;N
CANDEIAS;58;STC;CORTE;2022-08-11;13;12;1;5;N
ITABUNA;232;STC;CORTE;2022-08-23;18;18;0;3;N
ITABUNA;185;EPS;RECORTE;2022-08-10;7;6;1;4;N
PAULO AFONSO;407;STC;CORTE;2022-08-09;11;11;0;3;N
VITORIA DA CONQUISTA;525;STC;CORTE;2022-08-09;11;11;0;3;N
GRACA;131;EPS;BAIXA;2022-08-25;10;6;4;5;S
CANDEIAS;59;EPS;DISJUNTOR;2022-08-17;8;7;1;4;N
LIVRAMENTO DE NOSSA SENHORA;311;EPS;RECORTE;2022-08-17;4;4;0;4;N
GRACA;129;STC;RECORTE;2022-08-16;17;16;1;3;N
IRECE;205;EPS;CORTE;2022-08-09;14;13;1;3;N
PORTO SEGURO;371;EPS;CORTE;2022-08-16;9;9;0;3;N
BRUMADO;37;EPS;CORTE;2022-08-04;6;5;1;5;N
LAURO DE FREITAS;297;STC;CORTE;2022-08-25;15;15;0;5;S
PORTO SEGURO;372;EPS;CORTE;2022-08-04;8;8;0;5;N
IBOTIRAMA;166;STC;CORTE;2022-08-09;9;8;1;3;N
POSTO DA MATA;387;STC;CORTE;2022-08-05;5;0;5;6;N
PIRAJA;351;EPS;CORTE;2022-08-05;17;0;17;6;N
RIBEIRA DO POMBAL;397;STC;RECORTE;2022-08-24;11;8;3;4;N
JACOBINA;534;STC;CORTE;2022-08-16;1;1;0;3;N
CONCEICAO DO COITE;72;EPS;CORTE;2022-08-19;7;7;0;6;N
ILHEUS;173;EPS;RECORTE;2022-08-18;15;15;0;5;N
SANTO AMARO;422;EPS;RECORTE;2022-08-03;18;17;1;4;N
ALAGOINHAS;4;EPS;RECORTE;2022-08-03;15;15;0;4;N
FEIRA DE SANTANA SUL;122;STC;RECORTE;2022-08-02;16;13;3;3;N
IRECE;201;EPS;CORTE;2022-08-08;10;10;0;2;N
LAURO DE FREITAS;293;EPS;CORTE;2022-08-12;16;16;0;6;N
VALENCA;494;STC;CORTE;2022-08-09;11;11;0;3;N
AMARGOSA;5;STC;CORTE;2022-08-16;19;19;0;3;N
PERIPERI;348;STC;RECORTE;2022-08-02;28;11;17;3;S
SERRINHA;456;STC;CORTE;2022-08-16;11;11;0;3;N
EUNAPOLIS;85;EPS;RECORTE;2022-08-04;5;5;0;5;N
TEIXEIRA DE FREITAS;476;EPS;CORTE;2022-08-02;11;11;0;3;N
PERIPERI;347;STC;RECORTE;2022-08-16;57;45;12;3;N
LAURO DE FREITAS;298;STC;RECORTE;2022-08-16;32;24;8;3;N
IRECE;205;EPS;RECORTE;2022-08-10;8;8;0;4;N
JEQUIE;270;EPS;RECORTE;2022-08-10;9;8;1;4;N
LAURO DE FREITAS;295;STC;CORTE;2022-08-02;32;29;3;3;N
VITORIA DA CONQUISTA;506;STC;CORTE;2022-08-16;11;11;0;3;N
CAMACARI;57;STC;CORTE;2022-08-02;12;11;1;3;N
VALENCA;492;EPS;CORTE;2022-08-19;13;13;0;6;N
AMARGOSA;5;EPS;CORTE;2022-08-02;14;14;0;3;N
JACOBINA;258;EPS;BAIXA;2022-08-04;5;3;2;5;N
ITABUNA;228;STC;CORTE;2022-08-22;16;14;2;2;N
REMANSO;389;EPS;RECORTE;2022-08-10;12;11;1;4;N
JUAZEIRO;285;STC;CORTE;2022-08-22;13;13;0;2;N
ITABUNA;232;STC;RECORTE;2022-08-24;18;14;4;4;N
JACOBINA;264;STC;CORTE;2022-08-19;7;7;0;6;N
RIBEIRA DO POMBAL;406;EPS;RECORTE;2022-08-25;9;7;2;5;N
JUAZEIRO;285;EPS;CORTE;2022-08-08;20;20;0;2;N
VITORIA DA CONQUISTA;513;EPS;BAIXA;2022-08-17;12;12;0;4;N
IBOTIRAMA;155;EPS;BAIXA;2022-08-05;4;4;0;6;N
RIBEIRA DO POMBAL;396;EPS;BAIXA;2022-08-22;7;7;0;2;N
ITABUNA;185;EPS;BAIXA;2022-08-10;1;1;0;4;N
BARREIRAS;20;EPS;CORTE;2022-08-23;7;7;0;3;N
PERIPERI;349;EPS;BAIXA;2022-08-25;18;17;1;5;S
PAULO AFONSO;328;EPS;CORTE;2022-08-12;8;8;0;6;N
JACOBINA;263;EPS;CORTE;2022-08-17;8;7;1;4;N
SENHOR DO BONFIM;447;STC;RECORTE;2022-08-15;15;15;0;2;N
GUANAMBI;142;EPS;CORTE;2022-08-22;5;5;0;2;N
PERIPERI;348;STC;RECORTE;2022-08-04;19;18;1;5;N
CAMACARI;55;EPS;CORTE;2022-08-12;7;7;0;6;N
JACOBINA;534;EPS;CORTE;2022-08-02;7;7;0;3;N
CAMACARI;56;STC;CORTE;2022-08-12;5;5;0;6;S
JUAZEIRO;290;STC;RECORTE;2022-08-12;16;8;8;6;N
GRACA;136;STC;CORTE;2022-08-05;15;0;15;6;N
JACOBINA;264;EPS;CORTE;2022-08-05;7;0;7;6;N
PAULO AFONSO;338;EPS;CORTE;2022-08-15;8;8;0;2;N
ITAPOAN;251;EPS;CORTE;2022-08-08;25;25;0;2;N
JEQUIE;275;EPS;CORTE;2022-08-23;27;27;0;3;N
BARREIRAS;18;STC;CORTE;2022-08-12;15;14;1;6;N
ITABUNA;232;EPS;BAIXA;2022-08-10;3;3;0;4;N
BARREIRAS;16;EPS;CORTE;2022-08-22;35;33;2;2;N
IRECE;198;STC;CORTE;2022-08-09;11;11;0;3;N
IRECE;196;EPS;CORTE;2022-08-19;9;9;0;6;N
ILHEUS;179;EPS;CORTE;2022-08-19;22;22;0;6;N
IPIAU;189;EPS;CORTE;2022-08-09;8;8;0;3;N
IRECE;211;EPS;CORTE;2022-08-11;13;12;1;5;N
ALAGOINHAS;1;STC;RECORTE;2022-08-02;40;20;20;3;S
SENHOR DO BONFIM;453;STC;CORTE;2022-08-16;13;12;1;3;N
SENHOR DO BONFIM;453;EPS;CORTE;2022-08-02;8;8;0;3;N
EUNAPOLIS;85;EPS;BAIXA;2022-08-04;4;4;0;5;N
SENHOR DO BONFIM;454;STC;CORTE;2022-08-04;13;13;0;5;N
BARREIRAS;20;EPS;RECORTE;2022-08-24;9;9;0;4;N
ESPLANADA;77;STC;CORTE;2022-08-11;11;11;0;5;N
SANTO ANTONIO DE JESUS;427;STC;RECORTE;2022-08-02;17;17;0;3;N
AMARGOSA;5;EPS;RECORTE;2022-08-03;10;10;0;4;N
PORTO SEGURO;377;EPS;CORTE;2022-08-18;10;10;0;5;N
VALENCA;493;STC;RECORTE;2022-08-22;17;15;2;2;N
SANTO ANTONIO DE JESUS;426;STC;RECORTE;2022-08-12;15;13;2;6;S
JEQUIE;281;STC;RECORTE;2022-08-15;11;11;0;2;N
JACOBINA;534;STC;RECORTE;2022-08-17;1;1;0;4;N
GUANAMBI;139;EPS;CORTE;2022-08-09;6;6;0;3;N
EUNAPOLIS;105;EPS;CORTE;2022-08-09;6;6;0;3;N
IBOTIRAMA;171;EPS;CORTE;2022-08-09;5;4;1;3;N
JACOBINA;263;EPS;RECORTE;2022-08-18;9;9;0;5;N
GUANAMBI;142;EPS;DISJUNTOR;2022-08-05;14;0;14;6;N
SERRINHA;466;EPS;CORTE;2022-08-05;7;0;7;6;N
VITORIA DA CONQUISTA;509;EPS;BAIXA;2022-08-16;16;0;16;3;N
SEABRA;440;EPS;CORTE;2022-08-25;10;0;10;5;N
PIRAJA;354;STC;CORTE;2022-08-08;17;16;1;2;N
FEIRA DE SANTANA SUL;122;STC;CORTE;2022-08-24;40;39;1;4;S
SANTO ANTONIO DE JESUS;432;STC;CORTE;2022-08-15;13;13;0;2;N
ESPLANADA;77;STC;RECORTE;2022-08-12;16;9;7;6;N
GRACA;132;EPS;CORTE;2022-08-16;42;37;5;3;N
IBOTIRAMA;167;STC;CORTE;2022-08-22;14;11;3;2;N
PITUBA;359;STC;CORTE;2022-08-18;19;19;0;5;N
FEIRA DE SANTANA SUL;121;EPS;CORTE;2022-08-24;16;14;2;4;N
JUAZEIRO;290;EPS;CORTE;2022-08-22;30;30;0;2;N
GRACA;133;EPS;CORTE;2022-08-04;50;49;1;5;N
AMARGOSA;10;EPS;CORTE;2022-08-16;5;5;0;3;N
AMARGOSA;11;STC;CORTE;2022-08-18;18;17;1;5;N
ITABERABA;215;EPS;CORTE;2022-08-04;6;5;1;5;N
PITUBA;359;EPS;CORTE;2022-08-04;22;22;0;5;N
BARREIRAS;13;STC;CORTE;2022-08-23;21;19;2;3;N
JUAZEIRO;291;EPS;CORTE;2022-08-10;15;15;0;4;N
PITUBA;358;EPS;CORTE;2022-08-16;19;18;1;3;N
GUANAMBI;151;STC;CORTE;2022-08-02;10;10;0;3;N
JUAZEIRO;292;STC;CORTE;2022-08-12;9;9;0;6;N
JEQUIE;275;EPS;RECORTE;2022-08-24;10;9;1;4;N
TEIXEIRA DE FREITAS;485;EPS;RECORTE;2022-08-18;32;30;2;5;N
FEIRA DE SANTANA SUL;122;EPS;CORTE;2022-08-12;18;18;0;6;N
VALENCA;490;STC;RECORTE;2022-08-09;17;7;10;3;N
JACOBINA;263;EPS;BAIXA;2022-08-18;5;5;0;5;N
GRACA;134;EPS;BAIXA;2022-08-16;7;6;1;3;N
PIRAJA;352;EPS;CORTE;2022-08-18;14;14;0;5;N
ITABERABA;217;EPS;BAIXA;2022-08-04;10;10;0;5;N
TEIXEIRA DE FREITAS;481;EPS;CORTE;2022-08-16;10;10;0;3;N
LIVRAMENTO DE NOSSA SENHORA;310;STC;CORTE;2022-08-18;4;4;0;5;N
ILHEUS;180;STC;RECORTE;2022-08-22;21;17;4;2;N
RIBEIRA DO POMBAL;400;EPS;CORTE;2022-08-24;9;8;1;4;N
ITABUNA;231;STC;RECORTE;2022-08-11;16;4;12;5;S
LUIS EDUARDO MAGALHAES;323;EPS;CORTE;2022-08-11;7;7;0;5;N
ESPLANADA;80;EPS;BAIXA;2022-08-11;1;1;0;5;N
BRUMADO;39;EPS;CORTE;2022-08-05;5;0;5;6;N
FEIRA DE SANTANA SUL;124;STC;CORTE;2022-08-02;1;1;0;3;N
ALAGOINHAS;2;EPS;CORTE;2022-08-02;32;31;1;3;N
ESPLANADA;81;EPS;CORTE;2022-08-23;14;12;2;3;N
JUAZEIRO;287;STC;CORTE;2022-08-23;8;8;0;3;N
SANTO AMARO;421;EPS;DISJUNTOR;2022-08-22;3;3;0;2;N
ITABUNA;172;STC;CORTE;2022-08-09;16;16;0;3;N
CAMACARI;51;STC;CORTE;2022-08-02;64;62;2;3;N
CAMACARI;55;STC;RECORTE;2022-08-02;5;1;4;3;S
LUIS EDUARDO MAGALHAES;320;STC;CORTE;2022-08-12;11;11;0;6;N
IRECE;203;STC;CORTE;2022-08-23;21;19;2;3;N
VITORIA DA CONQUISTA;500;EPS;CORTE;2022-08-02;15;14;1;3;N
IBOTIRAMA;156;STC;CORTE;2022-08-08;9;9;0;2;N
SANTO ANTONIO DE JESUS;9;STC;RECORTE;2022-08-16;16;16;0;3;N
VALENCA;498;EPS;DISJUNTOR;2022-08-04;15;14;1;5;N
ITAPETINGA;239;STC;CORTE;2022-08-02;9;9;0;3;N
VITORIA DA CONQUISTA;500;STC;CORTE;2022-08-16;11;11;0;3;N
BRUMADO;35;STC;CORTE;2022-08-18;11;11;0;5;N
ILHEUS;187;STC;CORTE;2022-08-11;8;8;0;5;N
REMANSO;393;EPS;CORTE;2022-08-12;8;8;0;6;N
ALAGOINHAS;3;STC;CORTE;2022-08-04;11;11;0;5;N
SANTO AMARO;420;STC;CORTE;2022-08-16;9;9;0;3;N
ALAGOINHAS;3;STC;CORTE;2022-08-02;13;13;0;3;S
PITUBA;358;EPS;RECORTE;2022-08-17;26;26;0;4;N
ITABUNA;226;EPS;RECORTE;2022-08-10;7;4;3;4;N
BRUMADO;49;EPS;CORTE;2022-08-08;7;7;0;2;N
VITORIA DA CONQUISTA;501;STC;CORTE;2022-08-04;11;10;1;5;N
PAULO AFONSO;335;STC;RECORTE;2022-08-17;16;15;1;4;N
BOM JESUS DA LAPA;34;EPS;CORTE;2022-08-18;5;4;1;5;N
LUIS EDUARDO MAGALHAES;318;EPS;CORTE;2022-08-22;2;2;0;2;N
JACOBINA;257;EPS;CORTE;2022-08-17;8;8;0;4;N
PITUBA;359;STC;RECORTE;2022-08-19;21;7;14;6;N
BRUMADO;40;STC;RECORTE;2022-08-08;11;9;2;2;N
IPIAU;189;EPS;BAIXA;2022-08-10;4;4;0;4;N
ESPLANADA;82;STC;CORTE;2022-08-25;11;11;0;5;N
RIBEIRA DO POMBAL;397;STC;CORTE;2022-08-25;11;11;0;5;N
PORTO SEGURO;372;EPS;DISJUNTOR;2022-08-12;19;19;0;6;N
ITABUNA;185;EPS;CORTE;2022-08-11;26;25;1;5;N
CAMACARI;50;STC;CORTE;2022-08-12;15;15;0;6;S
GRACA;130;STC;CORTE;2022-08-05;17;0;17;6;N
TEIXEIRA DE FREITAS;479;STC;CORTE;2022-08-05;17;0;17;6;N
PITUBA;356;STC;CORTE;2022-08-05;38;0;38;6;N
JACOBINA;258;EPS;CORTE;2022-08-05;9;0;9;6;N
JACOBINA;257;EPS;RECORTE;2022-08-18;9;8;1;5;N
LAURO DE FREITAS;298;EPS;CORTE;2022-08-03;28;28;0;4;N
PIRAJA;350;EPS;CORTE;2022-08-19;14;14;0;6;N
REMANSO;389;STC;CORTE;2022-08-23;37;37;0;3;S
SERRINHA;459;EPS;CORTE;2022-08-17;7;6;1;4;N
IPIAU;531;STC;RECORTE;2022-08-16;21;20;1;3;N
VALENCA;495;STC;RECORTE;2022-08-23;17;17;0;3;N
SANTA MARIA DA VITORIA;535;STC;CORTE;2022-08-17;17;11;6;4;N
PAULO AFONSO;407;STC;CORTE;2022-08-11;11;11;0;5;N
ITABUNA;184;EPS;RECORTE;2022-08-24;33;29;4;4;N
VITORIA DA CONQUISTA;510;STC;CORTE;2022-08-19;11;10;1;6;N
BOM JESUS DA LAPA;31;STC;CORTE;2022-08-19;16;15;1;6;N
SENHOR DO BONFIM;447;EPS;CORTE;2022-08-02;8;7;1;3;N
JUAZEIRO;290;EPS;BAIXA;2022-08-23;57;49;8;3;N
PITUBA;359;EPS;BAIXA;2022-08-05;40;36;4;6;N
AMARGOSA;10;EPS;BAIXA;2022-08-17;2;2;0;4;N
VITORIA DA CONQUISTA;503;EPS;BAIXA;2022-08-16;13;13;0;3;N
ITABUNA;226;EPS;BAIXA;2022-08-10;3;2;1;4;N
CONCEICAO DO COITE;76;EPS;CORTE;2022-08-22;5;5;0;2;N
RIBEIRA DO POMBAL;399;STC;RECORTE;2022-08-02;11;11;0;3;N
LAURO DE FREITAS;298;EPS;BAIXA;2022-08-25;15;15;0;5;S
REMANSO;389;EPS;CORTE;2022-08-11;8;8;0;5;N
LIVRAMENTO DE NOSSA SENHORA;308;STC;CORTE;2022-08-19;8;8;0;6;N
PAULO AFONSO;324;STC;RECORTE;2022-08-03;1;1;0;4;N
BRUMADO;46;STC;CORTE;2022-08-09;11;10;1;3;N
IPIAU;526;EPS;CORTE;2022-08-12;8;8;0;6;N
IRECE;192;STC;CORTE;2022-08-09;11;10;1;3;N
PERIPERI;348;STC;CORTE;2022-08-05;16;0;16;6;N
EUNAPOLIS;85;EPS;CORTE;2022-08-05;6;0;6;6;N
POSTO DA MATA;386;EPS;CORTE;2022-08-05;7;0;7;6;N
IRECE;203;STC;RECORTE;2022-08-24;21;21;0;4;N
ITABUNA;236;STC;RECORTE;2022-08-25;14;13;1;5;S
RIBEIRA DO POMBAL;404;STC;CORTE;2022-08-15;11;11;0;2;N
IBOTIRAMA;161;EPS;CORTE;2022-08-08;7;5;2;2;N
VITORIA DA CONQUISTA;520;EPS;CORTE;2022-08-08;20;19;1;2;N
JUAZEIRO;285;EPS;CORTE;2022-08-10;15;15;0;4;N
FEIRA DE SANTANA NORTE;115;EPS;RECORTE;2022-08-10;80;71;9;4;N
LAURO DE FREITAS;298;EPS;RECORTE;2022-08-04;20;19;1;5;N
AMARGOSA;5;EPS;CORTE;2022-08-04;28;28;0;5;N
ITABERABA;217;STC;CORTE;2022-08-19;42;42;0;6;N
SANTA MARIA DA VITORIA;414;STC;CORTE;2022-08-22;16;16;0;2;N
JUAZEIRO;286;STC;CORTE;2022-08-12;9;9;0;6;N
SERRINHA;459;EPS;RECORTE;2022-08-18;7;7;0;5;N
ESPLANADA;80;EPS;CORTE;2022-08-12;14;14;0;6;N
SENHOR DO BONFIM;447;EPS;RECORTE;2022-08-03;7;6;1;4;N
LAURO DE FREITAS;295;STC;CORTE;2022-08-02;40;40;0;3;S
ITABUNA;227;EPS;CORTE;2022-08-22;8;8;0;2;N
SANTO ANTONIO DE JESUS;434;STC;CORTE;2022-08-16;19;19;0;3;N
ITABERABA;218;STC;CORTE;2022-08-05;6;6;0;6;S
JACOBINA;263;EPS;CORTE;2022-08-19;8;7;1;6;N
SERRINHA;455;EPS;CORTE;2022-08-16;7;7;0;3;N
CONCEICAO DO COITE;64;STC;RECORTE;2022-08-09;11;6;5;3;N
VITORIA DA CONQUISTA;520;STC;CORTE;2022-08-22;11;11;0;2;N
CAMACARI;57;STC;CORTE;2022-08-04;11;11;0;5;N
ILHEUS;186;EPS;BAIXA;2022-08-10;6;6;0;4;N
PERIPERI;348;STC;RECORTE;2022-08-04;8;8;0;5;S
PERIPERI;347;STC;RECORTE;2022-08-18;19;19;0;5;N
JUAZEIRO;284;EPS;CORTE;2022-08-22;15;15;0;2;N
VALENCA;493;EPS;CORTE;2022-08-09;8;7;1;3;N
LIVRAMENTO DE NOSSA SENHORA;309;STC;RECORTE;2022-08-08;15;15;0;2;N
ITABERABA;217;EPS;CORTE;2022-08-05;6;0;6;6;N
PERIPERI;347;STC;RECORTE;2022-08-16;6;3;3;3;S
BARREIRAS;20;EPS;CORTE;2022-08-25;6;0;6;5;N
JACOBINA;261;STC;CORTE;2022-08-08;32;32;0;2;N
PAULO AFONSO;325;STC;CORTE;2022-08-15;11;11;0;2;N
IRECE;197;STC;CORTE;2022-08-23;21;21;0;3;N
VALENCA;491;EPS;DISJUNTOR;2022-08-16;15;15;0;3;N
CONCEICAO DO COITE;71;EPS;DISJUNTOR;2022-08-16;6;6;0;3;N
ITABERABA;213;STC;CORTE;2022-08-18;21;21;0;5;N
VITORIA DA CONQUISTA;517;STC;CORTE;2022-08-09;11;11;0;3;N
JEQUIE;277;STC;CORTE;2022-08-15;10;10;0;2;N
SENHOR DO BONFIM;453;EPS;CORTE;2022-08-04;7;7;0;5;N
IBOTIRAMA;170;EPS;CORTE;2022-08-23;7;7;0;3;N
ITAPOAN;252;STC;CORTE;2022-08-12;19;15;4;6;N
PORTO SEGURO;369;STC;RECORTE;2022-08-08;16;16;0;2;N
JEQUIE;266;STC;RECORTE;2022-08-23;6;3;3;3;S
VALENCA;493;EPS;RECORTE;2022-08-10;26;21;5;4;N
TEIXEIRA DE FREITAS;472;EPS;CORTE;2022-08-03;8;8;0;4;N
PORTO SEGURO;363;EPS;CORTE;2022-08-16;14;14;0;3;N
PERIPERI;347;EPS;BAIXA;2022-08-04;5;5;0;5;N
EUNAPOLIS;92;STC;CORTE;2022-08-09;11;11;0;3;N
SENHOR DO BONFIM;453;STC;CORTE;2022-08-16;12;12;0;3;S
JEQUIE;281;EPS;RECORTE;2022-08-03;2;2;0;4;N
JUAZEIRO;285;EPS;RECORTE;2022-08-11;8;7;1;5;N
FEIRA DE SANTANA SUL;127;EPS;CORTE;2022-08-03;14;14;0;4;N
IRECE;197;EPS;CORTE;2022-08-09;14;13;1;3;N
GUANAMBI;139;EPS;CORTE;2022-08-11;7;7;0;5;N
IBOTIRAMA;156;EPS;CORTE;2022-08-19;7;7;0;6;N
ALAGOINHAS;1;STC;RECORTE;2022-08-04;40;31;9;5;S
ITABERABA;217;STC;RECORTE;2022-08-18;12;11;1;5;S
VITORIA DA CONQUISTA;515;EPS;CORTE;2022-08-19;14;13;1;6;N
IPIAU;188;EPS;CORTE;2022-08-23;7;7;0;3;N
GUANAMBI;138;EPS;CORTE;2022-08-23;5;5;0;3;N
VALENCA;489;EPS;CORTE;2022-08-08;10;10;0;2;N
LAURO DE FREITAS;298;EPS;BAIXA;2022-08-04;5;5;0;5;N
SEABRA;443;STC;CORTE;2022-08-05;11;0;11;6;N
FEIRA DE SANTANA SUL;128;STC;CORTE;2022-08-05;1;0;1;6;N
SANTO ANTONIO DE JESUS;431;EPS;CORTE;2022-08-15;4;4;0;2;N
FEIRA DE SANTANA SUL;127;EPS;RECORTE;2022-08-04;16;16;0;5;N
IRECE;193;STC;CORTE;2022-08-22;42;40;2;2;N
FEIRA DE SANTANA SUL;123;EPS;CORTE;2022-08-02;54;49;5;3;N
SERRINHA;456;EPS;BAIXA;2022-08-05;24;22;2;6;N
ITAPETINGA;241;EPS;CORTE;2022-08-15;12;12;0;2;N
JUAZEIRO;291;EPS;CORTE;2022-08-12;15;14;1;6;N
SEABRA;439;STC;CORTE;2022-08-04;10;10;0;5;N
IBOTIRAMA;171;STC;RECORTE;2022-08-24;12;11;1;4;S
SEABRA;442;EPS;RECORTE;2022-08-04;8;7;1;5;N
ILHEUS;180;STC;DISJUNTOR;2022-08-04;19;18;1;5;S
JUAZEIRO;290;EPS;CORTE;2022-08-24;32;30;2;4;N
PIRAJA;353;STC;CORTE;2022-08-22;17;17;0;2;N
IRECE;207;EPS;CORTE;2022-08-12;13;13;0;6;N
POSTO DA MATA;387;EPS;CORTE;2022-08-18;14;14;0;5;N
SANTO AMARO;424;STC;CORTE;2022-08-19;21;21;0;6;N
PIRAJA;353;EPS;CORTE;2022-08-08;19;18;1;2;N
PERIPERI;349;STC;CORTE;2022-08-18;7;6;1;5;N
IBOTIRAMA;168;STC;CORTE;2022-08-12;9;9;0;6;N
TEIXEIRA DE FREITAS;469;STC;CORTE;2022-08-04;16;16;0;5;N
ILHEUS;180;EPS;RECORTE;2022-08-10;7;7;0;4;N
IRECE;197;EPS;RECORTE;2022-08-10;8;7;1;4;N
IRECE;211;EPS;RECORTE;2022-08-12;12;4;8;6;S
IPIAU;188;EPS;RECORTE;2022-08-24;8;8;0;4;N
JACOBINA;261;STC;RECORTE;2022-08-09;16;15;1;3;N
FEIRA DE SANTANA SUL;123;STC;CORTE;2022-08-16;1;1;0;3;N
IBOTIRAMA;167;EPS;CORTE;2022-08-10;5;5;0;4;N
JUAZEIRO;285;EPS;BAIXA;2022-08-11;7;6;1;5;N
LIVRAMENTO DE NOSSA SENHORA;304;EPS;BAIXA;2022-08-05;5;5;0;6;N
GRACA;134;EPS;BAIXA;2022-08-18;14;11;3;5;N
SERRINHA;463;STC;CORTE;2022-08-08;11;11;0;2;N
VITORIA DA CONQUISTA;503;EPS;CORTE;2022-08-17;15;15;0;4;N
PIRAJA;355;EPS;DISJUNTOR;2022-08-16;17;17;0;3;N
SANTO ANTONIO DE JESUS;8;EPS;CORTE;2022-08-15;4;4;0;2;N
GUANAMBI;151;STC;CORTE;2022-08-04;11;11;0;5;N
ILHEUS;180;STC;RECORTE;2022-08-22;8;7;1;2;S
BRUMADO;44;STC;RECORTE;2022-08-09;5;5;0;3;S
RIBEIRA DO POMBAL;406;EPS;RECORTE;2022-08-04;7;5;2;5;N
PAULO AFONSO;334;EPS;CORTE;2022-08-16;8;8;0;3;N
SENHOR DO BONFIM;448;EPS;CORTE;2022-08-15;6;6;0;2;N
SANTA MARIA DA VITORIA;412;EPS;CORTE;2022-08-09;8;8;0;3;N
ITABERABA;224;STC;CORTE;2022-08-09;11;11;0;3;N
VITORIA DA CONQUISTA;525;EPS;CORTE;2022-08-22;5;5;0;2;N
SENHOR DO BONFIM;450;STC;CORTE;2022-08-05;13;0;13;6;N
SANTO AMARO;424;EPS;CORTE;2022-08-05;21;0;21;6;N
ILHEUS;180;STC;RECORTE;2022-08-24;21;21;0;4;N
IRECE;197;STC;RECORTE;2022-08-24;21;19;2;4;N
VITORIA DA CONQUISTA;519;EPS;BAIXA;2022-08-19;7;0;7;6;S
SANTO AMARO;419;EPS;CORTE;2022-08-16;22;22;0;3;N
EUNAPOLIS;97;STC;CORTE;2022-08-23;21;21;0;3;N
EUNAPOLIS;98;STC;CORTE;2022-08-11;21;20;1;5;N
FEIRA DE SANTANA NORTE;109;EPS;RECORTE;2022-08-10;68;67;1;4;N
CAMACARI;51;STC;CORTE;2022-08-04;16;15;1;5;N
IBOTIRAMA;163;STC;CORTE;2022-08-23;16;11;5;3;N
POSTO DA MATA;378;EPS;BAIXA;2022-08-04;14;14;0;5;N
SANTO ANTONIO DE JESUS;428;STC;CORTE;2022-08-16;19;19;0;3;N
VITORIA DA CONQUISTA;500;STC;CORTE;2022-08-18;11;11;0;5;N
SANTA MARIA DA VITORIA;412;EPS;RECORTE;2022-08-10;4;3;1;4;N
ALAGOINHAS;1;EPS;CORTE;2022-08-16;30;29;1;3;N
PAULO AFONSO;346;STC;CORTE;2022-08-09;11;10;1;3;N
CAMACARI;51;STC;CORTE;2022-08-02;10;9;1;3;S
CAMACARI;50;EPS;CORTE;2022-08-02;18;18;0;3;N
SANTO AMARO;420;STC;CORTE;2022-08-18;21;21;0;5;N
ILHEUS;186;EPS;CORTE;2022-08-11;22;21;1;5;N
PITUBA;356;STC;CORTE;2022-08-05;5;5;0;6;S
VITORIA DA CONQUISTA;499;EPS;CORTE;2022-08-16;15;15;0;3;N
JUAZEIRO;286;EPS;CORTE;2022-08-23;15;14;1;3;N
LUIS EDUARDO MAGALHAES;319;EPS;CORTE;2022-08-12;7;7;0;6;N
ALAGOINHAS;2;EPS;CORTE;2022-08-04;36;35;1;5;N
JUAZEIRO;290;EPS;RECORTE;2022-08-25;55;32;23;5;N
SANTO AMARO;420;EPS;CORTE;2022-08-04;15;15;0;5;N
CONCEICAO DO COITE;68;STC;CORTE;2022-08-11;11;11;0;5;N
SANTO ANTONIO DE JESUS;428;EPS;CORTE;2022-08-02;12;11;1;3;N
ITAPETINGA;239;STC;CORTE;2022-08-04;9;9;0;5;N
ESPLANADA;83;STC;CORTE;2022-08-15;11;11;0;2;N
VITORIA DA CONQUISTA;503;EPS;RECORTE;2022-08-18;16;16;0;5;N
ITABUNA;225;EPS;RECORTE;2022-08-24;11;9;2;4;N
IPIAU;188;EPS;BAIXA;2022-08-24;3;3;0;4;N
TEIXEIRA DE FREITAS;469;STC;RECORTE;2022-08-03;4;1;3;4;S
FEIRA DE SANTANA SUL;123;STC;RECORTE;2022-08-17;23;6;17;4;N
IRECE;203;EPS;CORTE;2022-08-11;13;12;1;5;N
SANTO AMARO;422;EPS;DISJUNTOR;2022-08-12;3;3;0;6;N
ITAPETINGA;242;EPS;RECORTE;2022-08-04;9;7;2;5;N
ITAPETINGA;242;STC;RECORTE;2022-08-18;13;7;6;5;N
IRECE;203;STC;CORTE;2022-08-25;19;16;3;5;N
JUAZEIRO;287;STC;CORTE;2022-08-25;8;8;0;5;N
FEIRA DE SANTANA SUL;127;EPS;BAIXA;2022-08-04;7;6;1;5;N
IBOTIRAMA;155;EPS;CORTE;2022-08-08;14;13;1;2;N
RIBEIRA DO POMBAL;397;STC;CORTE;2022-08-25;7;7;0;5;S
ALAGOINHAS;2;STC;CORTE;2022-08-18;1;1;0;5;N
FEIRA DE SANTANA SUL;124;STC;RECORTE;2022-08-05;16;0;16;6;N
GRACA;129;EPS;CORTE;2022-08-05;25;0;25;6;N
IRECE;197;EPS;BAIXA;2022-08-10;4;0;4;4;N
VALENCA;494;EPS;CORTE;2022-08-22;11;11;0;2;N
PITUBA;356;EPS;DISJUNTOR;2022-08-25;4;0;4;5;N
ITAPOAN;252;EPS;CORTE;2022-08-23;126;116;10;3;N
ITABUNA;233;STC;CORTE;2022-08-15;16;16;0;2;N
SANTO AMARO;419;EPS;RECORTE;2022-08-17;21;19;2;4;N
ITAPETINGA;248;STC;CORTE;2022-08-19;9;7;2;6;N
REMANSO;390;STC;CORTE;2022-08-15;18;17;1;2;N
ITAPETINGA;242;EPS;BAIXA;2022-08-04;9;8;1;5;N
IPIAU;527;EPS;CORTE;2022-08-02;11;8;3;3;N
BRUMADO;45;STC;CORTE;2022-08-23;11;11;0;3;N
SENHOR DO BONFIM;447;EPS;CORTE;2022-08-04;7;7;0;5;N
ALAGOINHAS;1;EPS;RECORTE;2022-08-17;14;14;0;4;N
JEQUIE;275;EPS;RECORTE;2022-08-03;9;9;0;4;N
ITABERABA;221;EPS;CORTE;2022-08-08;6;6;0;2;N
PIRAJA;351;EPS;CORTE;2022-08-09;17;17;0;3;N
BARREIRAS;13;STC;CORTE;2022-08-02;14;14;0;3;N
JACOBINA;255;STC;CORTE;2022-08-08;21;20;1;2;N
RIBEIRA DO POMBAL;408;STC;CORTE;2022-08-18;11;11;0;5;N
BRUMADO;46;STC;CORTE;2022-08-11;11;9;2;5;N
SERRINHA;459;EPS;CORTE;2022-08-19;7;7;0;6;N
SANTO ANTONIO DE JESUS;432;EPS;BAIXA;2022-08-04;18;12;6;5;N
CAMACARI;51;STC;RECORTE;2022-08-03;4;3;1;4;S
RIBEIRA DO POMBAL;400;EPS;BAIXA;2022-08-25;20;18;2;5;S
FEIRA DE SANTANA NORTE;115;EPS;CORTE;2022-08-11;20;18;2;5;N
ITAPETINGA;247;EPS;CORTE;2022-08-17;12;10;2;4;N
ITAPOAN;253;STC;CORTE;2022-08-25;19;18;1;5;N
SANTA MARIA DA VITORIA;417;EPS;CORTE;2022-08-23;2;2;0;3;N
ILHEUS;174;EPS;CORTE;2022-08-09;7;7;0;3;N
ITABUNA;232;STC;CORTE;2022-08-25;7;7;0;5;S
CONCEICAO DO COITE;68;STC;RECORTE;2022-08-12;11;5;6;6;N
ALAGOINHAS;2;STC;RECORTE;2022-08-19;16;8;8;6;N
LAURO DE FREITAS;298;EPS;CORTE;2022-08-05;19;0;19;6;N
PERIPERI;347;EPS;CORTE;2022-08-05;32;0;32;6;N
JEQUIE;269;EPS;CORTE;2022-08-25;12;0;12;5;N
SENHOR DO BONFIM;446;EPS;RECORTE;2022-08-17;11;11;0;4;N
JEQUIE;268;STC;CORTE;2022-08-02;11;10;1;3;N
VITORIA DA CONQUISTA;519;EPS;CORTE;2022-08-22;14;14;0;2;N
SANTO ANTONIO DE JESUS;433;EPS;CORTE;2022-08-16;4;4;0;3;N
PAULO AFONSO;403;STC;CORTE;2022-08-12;11;11;0;6;N
JUAZEIRO;284;EPS;CORTE;2022-08-24;16;16;0;4;N
FEIRA DE SANTANA NORTE;112;STC;CORTE;2022-08-12;16;16;0;6;N
GRACA;134;EPS;CORTE;2022-08-19;42;36;6;6;N
GRACA;136;STC;CORTE;2022-08-09;17;13;4;3;N
LAURO DE FREITAS;293;EPS;CORTE;2022-08-16;16;16;0;3;N
CANDEIAS;58;STC;RECORTE;2022-08-16;48;43;5;3;N
SANTO ANTONIO DE JESUS;434;EPS;CORTE;2022-08-04;12;11;1;5;N
SANTA MARIA DA VITORIA;417;EPS;RECORTE;2022-08-24;5;5;0;4;N
JACOBINA;264;EPS;CORTE;2022-08-09;9;9;0;3;N
BRUMADO;44;STC;DISJUNTOR;2022-08-16;10;10;0;3;S
CONCEICAO DO COITE;76;EPS;RECORTE;2022-08-25;6;5;1;5;N
VALENCA;495;EPS;BAIXA;2022-08-11;2;2;0;5;N
PAULO AFONSO;328;EPS;CORTE;2022-08-16;8;8;0;3;N
POSTO DA MATA;381;EPS;CORTE;2022-08-18;7;7;0;5;N
JUAZEIRO;285;EPS;CORTE;2022-08-12;15;14;1;6;N
CONCEICAO DO COITE;72;EPS;CORTE;2022-08-23;7;7;0;3;N
FEIRA DE SANTANA SUL;122;STC;RECORTE;2022-08-04;30;18;12;5;S
VITORIA DA CONQUISTA;520;EPS;CORTE;2022-08-10;15;14;1;4;N
IBOTIRAMA;160;EPS;CORTE;2022-08-22;3;3;0;2;N
SANTA MARIA DA VITORIA;413;EPS;CORTE;2022-08-22;2;2;0;2;N
ITABERABA;216;EPS;CORTE;2022-08-19;3;3;0;6;N
ALAGOINHAS;2;EPS;BAIXA;2022-08-05;11;10;1;6;N
SANTO AMARO;420;EPS;BAIXA;2022-08-05;14;13;1;6;N
ESPLANADA;81;EPS;CORTE;2022-08-02;12;12;0;3;N
ESPLANADA;77;STC;CORTE;2022-08-15;22;22;0;2;N
JUAZEIRO;284;EPS;RECORTE;2022-08-25;11;10;1;5;N
ITAPOAN;253;STC;CORTE;2022-08-02;19;13;6;3;N
ITAPOAN;251;EPS;CORTE;2022-08-12;46;43;3;6;N
VITORIA DA CONQUISTA;516;STC;CORTE;2022-08-23;8;8;0;3;N
VALENCA;495;STC;RECORTE;2022-08-02;34;29;5;3;N
BARREIRAS;18;STC;CORTE;2022-08-16;15;12;3;3;N
ILHEUS;180;STC;CORTE;2022-08-23;21;20;1;3;S
ITABUNA;227;STC;DISJUNTOR;2022-08-19;20;20;0;6;S
VITORIA DA CONQUISTA;520;EPS;RECORTE;2022-08-11;15;14;1;5;N
FEIRA DE SANTANA NORTE;108;STC;CORTE;2022-08-11;19;18;1;5;N
GUANAMBI;142;EPS;DISJUNTOR;2022-08-09;11;11;0;3;N
IPIAU;532;EPS;CORTE;2022-08-16;8;7;1;3;N
ITABERABA;214;STC;CORTE;2022-08-08;11;10;1;2;N
REMANSO;395;EPS;CORTE;2022-08-15;8;8;0;2;N
ESPLANADA;82;STC;RECORTE;2022-08-03;12;10;2;4;S
CONCEICAO DO COITE;68;EPS;CORTE;2022-08-22;7;7;0;2;N
SERRINHA;456;STC;RECORTE;2022-08-19;5;1;4;6;S
IRECE;197;EPS;CORTE;2022-08-11;13;11;2;5;N
FEIRA DE SANTANA NORTE;107;STC;CORTE;2022-08-23;1;1;0;3;N
AMARGOSA;6;STC;RECORTE;2022-08-09;18;8;10;3;N
LAURO DE FREITAS;294;EPS;RECORTE;2022-08-05;9;9;0;6;N
ILHEUS;179;EPS;CORTE;2022-08-23;45;44;1;3;N
SERRINHA;466;EPS;CORTE;2022-08-09;6;6;0;3;N
IBOTIRAMA;161;EPS;RECORTE;2022-08-11;7;7;0;5;N
IBOTIRAMA;157;EPS;CORTE;2022-08-09;5;5;0;3;N
CAMACARI;53;STC;CORTE;2022-08-05;16;0;16;6;N
JEQUIE;278;STC;CORTE;2022-08-05;11;0;11;6;N
VITORIA DA CONQUISTA;519;EPS;DISJUNTOR;2022-08-05;11;0;11;6;N
FEIRA DE SANTANA SUL;127;EPS;CORTE;2022-08-05;23;0;23;6;N
POSTO DA MATA;378;EPS;CORTE;2022-08-05;10;0;10;6;N
LUIS EDUARDO MAGALHAES;320;EPS;CORTE;2022-08-25;7;0;7;5;N
GUANAMBI;138;EPS;CORTE;2022-08-25;4;0;4;5;N
IPIAU;188;EPS;CORTE;2022-08-25;7;0;7;5;N
RIBEIRA DO POMBAL;410;STC;CORTE;2022-08-19;11;11;0;6;N
JEQUIE;273;STC;CORTE;2022-08-16;11;11;0;3;N
BRUMADO;40;STC;CORTE;2022-08-11;11;11;0;5;N
AMARGOSA;11;STC;CORTE;2022-08-22;18;17;1;2;N
CONCEICAO DO COITE;65;STC;CORTE;2022-08-23;11;11;0;3;N
BARREIRAS;14;STC;CORTE;2022-08-15;15;15;0;2;N
SEABRA;437;EPS;CORTE;2022-08-16;14;14;0;3;N
PIRAJA;354;STC;CORTE;2022-08-12;17;17;0;6;N
FEIRA DE SANTANA SUL;126;EPS;RECORTE;2022-08-18;14;14;0;5;N
ESPLANADA;78;STC;RECORTE;2022-08-02;6;5;1;3;S
LIVRAMENTO DE NOSSA SENHORA;310;STC;CORTE;2022-08-22;4;4;0;2;N
ILHEUS;178;EPS;DISJUNTOR;2022-08-18;31;27;4;5;N
REMANSO;392;STC;CORTE;2022-08-16;9;9;0;3;N
PIRAJA;352;EPS;CORTE;2022-08-22;39;39;0;2;N
FEIRA DE SANTANA SUL;122;EPS;CORTE;2022-08-16;18;17;1;3;N
JUAZEIRO;292;STC;CORTE;2022-08-16;9;9;0;3;N
PORTO SEGURO;374;STC;CORTE;2022-08-23;21;21;0;3;N
SANTO ANTONIO DE JESUS;9;STC;CORTE;2022-08-17;15;15;0;4;S
ESPLANADA;77;STC;RECORTE;2022-08-16;16;14;2;3;N
JACOBINA;260;STC;RECORTE;2022-08-23;11;10;1;3;N
JUAZEIRO;292;EPS;CORTE;2022-08-02;16;16;0;3;N
AMARGOSA;11;EPS;CORTE;2022-08-08;21;20;1;2;N
EUNAPOLIS;87;EPS;CORTE;2022-08-08;8;8;0;2;N
JACOBINA;255;EPS;CORTE;2022-08-19;8;8;0;6;N
IBOTIRAMA;169;STC;CORTE;2022-08-02;9;9;0;3;N
ILHEUS;179;EPS;RECORTE;2022-08-24;8;7;1;4;N
SENHOR DO BONFIM;454;STC;RECORTE;2022-08-09;17;11;6;3;N
PITUBA;359;EPS;CORTE;2022-08-08;27;27;0;2;N
LAURO DE FREITAS;294;EPS;BAIXA;2022-08-05;19;16;3;6;N
PERIPERI;348;EPS;CORTE;2022-08-18;24;18;6;5;N
TEIXEIRA DE FREITAS;473;STC;RECORTE;2022-08-08;17;16;1;2;N
IRECE;198;STC;RECORTE;2022-08-12;18;8;10;6;S
ITAPOAN;253;STC;RECORTE;2022-08-03;19;16;3;4;N
ITAPOAN;251;EPS;RECORTE;2022-08-11;19;10;9;5;S
GUANAMBI;150;EPS;CORTE;2022-08-04;7;7;0;5;N
IRECE;192;EPS;CORTE;2022-08-22;4;4;0;2;N
IBOTIRAMA;166;EPS;CORTE;2022-08-24;5;5;0;4;N
FEIRA DE SANTANA SUL;123;STC;CORTE;2022-08-18;1;1;0;5;N
PIRAJA;355;EPS;DISJUNTOR;2022-08-18;23;21;2;5;N
SERRINHA;462;EPS;CORTE;2022-08-08;8;8;0;2;N
RIBEIRA DO POMBAL;404;EPS;BAIXA;2022-08-04;7;7;0;5;N
PORTO SEGURO;377;EPS;DISJUNTOR;2022-08-05;17;0;17;6;N
SANTO ANTONIO DE JESUS;9;EPS;CORTE;2022-08-05;12;0;12;6;N
SENHOR DO BONFIM;449;EPS;CORTE;2022-08-05;7;0;7;6;N
SANTO ANTONIO DE JESUS;432;EPS;CORTE;2022-08-05;6;0;6;6;N
IBOTIRAMA;158;STC;RECORTE;2022-08-12;1;0;1;6;N
VITORIA DA CONQUISTA;519;EPS;BAIXA;2022-08-23;1;0;1;3;N
EUNAPOLIS;86;EPS;DISJUNTOR;2022-08-03;6;6;0;4;N
PORTO SEGURO;370;EPS;CORTE;2022-08-08;11;11;0;2;N
IPIAU;532;EPS;BAIXA;2022-08-17;4;4;0;4;N
SANTO AMARO;423;EPS;DISJUNTOR;2022-08-02;4;4;0;3;N
LAURO DE FREITAS;296;STC;CORTE;2022-08-17;34;34;0;4;S
IBOTIRAMA;162;EPS;CORTE;2022-08-23;6;6;0;3;N
VALENCA;495;EPS;CORTE;2022-08-12;19;19;0;6;N
PITUBA;356;STC;CORTE;2022-08-09;19;18;1;3;N
GRACA;130;STC;CORTE;2022-08-09;34;29;5;3;N
ITAPETINGA;237;EPS;CORTE;2022-08-16;10;8;2;3;N
TEIXEIRA DE FREITAS;480;EPS;DISJUNTOR;2022-08-15;18;18;0;2;N
ALAGOINHAS;1;EPS;CORTE;2022-08-18;30;29;1;5;N
ALAGOINHAS;3;STC;CORTE;2022-08-08;11;11;0;2;N
AMARGOSA;11;STC;RECORTE;2022-08-23;18;18;0;3;N
LUIS EDUARDO MAGALHAES;320;EPS;CORTE;2022-08-02;9;9;0;3;N
LAURO DE FREITAS;295;EPS;CORTE;2022-08-17;16;16;0;4;N
PAULO AFONSO;346;STC;CORTE;2022-08-11;11;11;0;5;N
SANTO ANTONIO DE JESUS;428;EPS;CORTE;2022-08-04;12;11;1;5;N
VITORIA DA CONQUISTA;501;STC;CORTE;2022-08-08;11;11;0;2;N
EUNAPOLIS;97;STC;CORTE;2022-08-23;10;10;0;3;S
PIRAJA;350;STC;CORTE;2022-08-11;17;16;1;5;N
ILHEUS;187;STC;CORTE;2022-08-15;10;9;1;2;N
SANTO AMARO;419;EPS;CORTE;2022-08-18;20;19;1;5;N
SANTO ANTONIO DE JESUS;427;EPS;CORTE;2022-08-16;4;4;0;3;N
PAULO AFONSO;336;STC;RECORTE;2022-08-09;11;11;0;3;N
SERRINHA;462;STC;RECORTE;2022-08-23;11;8;3;3;N
TEIXEIRA DE FREITAS;479;STC;CORTE;2022-08-09;17;17;0;3;N
ILHEUS;179;EPS;BAIXA;2022-08-24;1;1;0;4;N
FEIRA DE SANTANA SUL;123;EPS;RECORTE;2022-08-05;26;26;0;6;N
VITORIA DA CONQUISTA;522;STC;CORTE;2022-08-25;11;11;0;5;N
IBOTIRAMA;163;STC;CORTE;2022-08-25;14;14;0;5;N
PAULO AFONSO;345;EPS;CORTE;2022-08-09;8;8;0;3;N
CAMACARI;52;EPS;BAIXA;2022-08-04;10;10;0;5;N
IRECE;203;STC;CORTE;2022-08-25;11;11;0;5;S
SEABRA;438;STC;RECORTE;2022-08-19;4;3;1;6;N
RIBEIRA DO POMBAL;399;STC;CORTE;2022-08-05;11;0;11;6;N
IPIAU;531;EPS;CORTE;2022-08-05;11;0;11;6;N
PIRAJA;353;STC;RECORTE;2022-08-25;17;6;11;5;N
ITAPOAN;254;STC;CORTE;2022-08-15;19;18;1;2;N
SANTO ANTONIO DE JESUS;427;EPS;RECORTE;2022-08-17;6;6;0;4;N
CANDEIAS;58;EPS;CORTE;2022-08-03;30;30;0;4;N
GUANAMBI;145;STC;DISJUNTOR;2022-08-10;30;30;0;4;S
SENHOR DO BONFIM;454;EPS;CORTE;2022-08-19;20;20;0;6;N
PORTO SEGURO;370;STC;RECORTE;2022-08-23;21;19;2;3;N
BOM JESUS DA LAPA;32;STC;CORTE;2022-08-11;10;10;0;5;N
GUANAMBI;142;STC;CORTE;2022-08-16;16;13;3;3;N
LAURO DE FREITAS;293;EPS;DISJUNTOR;2022-08-24;36;36;0;4;N
ESPLANADA;79;STC;CORTE;2022-08-16;26;26;0;3;N
ILHEUS;187;STC;RECORTE;2022-08-16;18;14;4;3;N
LUIS EDUARDO MAGALHAES;320;EPS;RECORTE;2022-08-03;7;7;0;4;N
BRUMADO;44;EPS;CORTE;2022-08-23;5;4;1;3;N
PIRAJA;353;EPS;BAIXA;2022-08-11;10;9;1;5;N
CONCEICAO DO COITE;64;STC;CORTE;2022-08-12;11;8;3;6;N
CONCEICAO DO COITE;63;EPS;CORTE;2022-08-10;7;7;0;4;N
PAULO AFONSO;345;EPS;RECORTE;2022-08-10;6;6;0;4;N
CAMACARI;50;EPS;RECORTE;2022-08-05;36;36;0;6;N
VALENCA;490;EPS;CORTE;2022-08-23;22;22;0;3;N
REMANSO;394;EPS;RECORTE;2022-08-05;4;4;0;6;N
PAULO AFONSO;341;STC;CORTE;2022-08-22;16;16;0;2;N
IPIAU;526;EPS;CORTE;2022-08-16;8;8;0;3;N
IRECE;206;EPS;BAIXA;2022-08-25;17;16;1;5;S
JUAZEIRO;290;EPS;BAIXA;2022-08-25;36;30;6;5;S
BRUMADO;45;EPS;CORTE;2022-08-11;6;6;0;5;N
FEIRA DE SANTANA SUL;123;EPS;BAIXA;2022-08-05;14;3;11;6;N
ITAPETINGA;238;STC;RECORTE;2022-08-17;18;14;4;4;S
CAMACARI;51;STC;RECORTE;2022-08-05;4;3;1;6;S
ITABUNA;234;STC;CORTE;2022-08-05;16;0;16;6;N
CANDEIAS;59;STC;CORTE;2022-08-05;13;0;13;6;N
ITABUNA;230;STC;CORTE;2022-08-04;16;16;0;5;N
IPIAU;526;EPS;RECORTE;2022-08-17;8;8;0;4;N
IBOTIRAMA;163;STC;CORTE;2022-08-02;9;6;3;3;N
FEIRA DE SANTANA NORTE;110;EPS;CORTE;2022-08-24;48;48;0;4;N
RIBEIRA DO POMBAL;404;STC;CORTE;2022-08-19;11;11;0;6;N
VITORIA DA CONQUISTA;519;EPS;CORTE;2022-08-24;28;26;2;4;N
VITORIA DA CONQUISTA;506;EPS;CORTE;2022-08-08;14;12;2;2;N
JUAZEIRO;286;EPS;CORTE;2022-08-02;14;13;1;3;N
GRACA;135;EPS;CORTE;2022-08-09;84;77;7;3;N
GUANAMBI;152;STC;CORTE;2022-08-19;21;20;1;6;N
ITAPOAN;254;STC;RECORTE;2022-08-16;19;17;2;3;N
AMARGOSA;5;EPS;CORTE;2022-08-08;14;12;2;2;N
ITABERABA;218;STC;CORTE;2022-08-11;11;10;1;5;N
CONCEICAO DO COITE;76;EPS;RECORTE;2022-08-25;17;11;6;5;S
BRUMADO;44;EPS;RECORTE;2022-08-24;3;2;1;4;N
VITORIA DA CONQUISTA;506;STC;CORTE;2022-08-22;11;11;0;2;N
ESPLANADA;83;EPS;BAIXA;2022-08-04;6;6;0;5;N
IBOTIRAMA;161;EPS;CORTE;2022-08-12;7;7;0;6;N
CANDEIAS;58;STC;RECORTE;2022-08-18;8;4;4;5;N
SERRINHA;456;EPS;CORTE;2022-08-08;8;7;1;2;N
REMANSO;390;STC;RECORTE;2022-08-18;11;11;0;5;N
BOM JESUS DA LAPA;27;EPS;CORTE;2022-08-08;6;4;2;2;N
ITABERABA;217;EPS;CORTE;2022-08-09;5;4;1;3;N
CONCEICAO DO COITE;61;EPS;DISJUNTOR;2022-08-17;6;6;0;4;N
VALENCA;491;STC;CORTE;2022-08-02;34;34;0;3;N
ITAPOAN;252;EPS;CORTE;2022-08-02;46;46;0;3;N
JACOBINA;260;EPS;CORTE;2022-08-10;7;7;0;4;N
RIBEIRA DO POMBAL;400;STC;CORTE;2022-08-18;11;9;2;5;N
IPIAU;189;EPS;CORTE;2022-08-15;8;8;0;2;N
JACOBINA;261;STC;CORTE;2022-08-12;36;35;1;6;N
PITUBA;359;EPS;DISJUNTOR;2022-08-16;13;11;2;3;N
PITUBA;357;STC;CORTE;2022-08-22;19;19;0;2;N
CAMACARI;52;STC;CORTE;2022-08-17;10;10;0;4;S
VITORIA DA CONQUISTA;506;STC;RECORTE;2022-08-23;11;7;4;3;N
VITORIA DA CONQUISTA;519;EPS;RECORTE;2022-08-25;16;14;2;5;N
CAMACARI;51;EPS;CORTE;2022-08-17;21;21;0;4;N
BARREIRAS;18;EPS;CORTE;2022-08-04;8;7;1;5;N
BARREIRAS;18;STC;CORTE;2022-08-18;21;21;0;5;N
SENHOR DO BONFIM;453;EPS;CORTE;2022-08-08;8;7;1;2;N
CAMACARI;57;STC;RECORTE;2022-08-09;13;8;5;3;N
ITABERABA;217;EPS;RECORTE;2022-08-10;6;6;0;4;N
JACOBINA;259;EPS;CORTE;2022-08-22;7;6;1;2;N
IBOTIRAMA;156;EPS;CORTE;2022-08-23;7;7;0;3;N
LUIS EDUARDO MAGALHAES;321;EPS;CORTE;2022-08-15;7;6;1;2;N
VITORIA DA CONQUISTA;509;EPS;BAIXA;2022-08-22;31;3;28;2;N
ITABUNA;233;EPS;BAIXA;2022-08-04;5;3;2;5;N
IBOTIRAMA;171;EPS;CORTE;2022-08-15;7;7;0;2;N
FEIRA DE SANTANA NORTE;110;EPS;RECORTE;2022-08-25;36;36;0;5;N
ITAPETINGA;245;STC;RECORTE;2022-08-09;13;10;3;3;N
REMANSO;390;EPS;BAIXA;2022-08-04;12;12;0;5;N
FEIRA DE SANTANA NORTE;107;STC;CORTE;2022-08-25;20;20;0;5;N
CONCEICAO DO COITE;68;EPS;CORTE;2022-08-24;7;7;0;4;N
IPIAU;532;EPS;CORTE;2022-08-18;8;7;1;5;N
IPIAU;526;EPS;BAIXA;2022-08-17;4;3;1;4;N
GUANAMBI;141;STC;CORTE;2022-08-05;11;0;11;6;N
LUIS EDUARDO MAGALHAES;323;STC;CORTE;2022-08-05;11;0;11;6;N
CAMACARI;52;EPS;CORTE;2022-08-05;19;0;19;6;N
PAULO AFONSO;325;EPS;CORTE;2022-08-05;9;0;9;6;N
ITABERABA;217;STC;RECORTE;2022-08-24;63;62;1;4;N
BRUMADO;44;EPS;BAIXA;2022-08-24;1;0;1;4;N
PIRAJA;353;EPS;CORTE;2022-08-12;48;47;1;6;N
RIBEIRA DO POMBAL;409;EPS;CORTE;2022-08-19;10;10;0;6;N
JUAZEIRO;292;STC;CORTE;2022-08-18;9;9;0;5;N
CANDEIAS;59;EPS;CORTE;2022-08-16;16;14;2;3;N
VITORIA DA CONQUISTA;513;STC;CORTE;2022-08-12;11;11;0;6;N
JACOBINA;256;EPS;CORTE;2022-08-09;9;9;0;3;N
CAMACARI;50;EPS;DISJUNTOR;2022-08-12;30;30;0;6;N
AMARGOSA;10;EPS;CORTE;2022-08-22;5;5;0;2;N
BARREIRAS;17;EPS;RECORTE;2022-08-17;8;8;0;4;N
AMARGOSA;12;STC;CORTE;2022-08-12;16;16;0;6;N
IRECE;193;EPS;CORTE;2022-08-12;39;37;2;6;N
GUANAMBI;151;STC;CORTE;2022-08-08;8;8;0;2;N
BOM JESUS DA LAPA;34;STC;CORTE;2022-08-12;11;11;0;6;N
REMANSO;391;EPS;CORTE;2022-08-16;20;20;0;3;N
JUAZEIRO;291;EPS;CORTE;2022-08-16;15;10;5;3;N
IRECE;208;EPS;CORTE;2022-08-04;13;10;3;5;N
IBOTIRAMA;154;STC;CORTE;2022-08-12;9;9;0;6;N
ITABERABA;222;EPS;CORTE;2022-08-23;4;4;0;3;N
PERIPERI;349;STC;CORTE;2022-08-22;6;6;0;2;N
EUNAPOLIS;102;EPS;CORTE;2022-08-02;6;6;0;3;N
CONCEICAO DO COITE;68;EPS;RECORTE;2022-08-25;6;4;2;5;N
FEIRA DE SANTANA NORTE;106;EPS;RECORTE;2022-08-24;4;3;1;4;N
SENHOR DO BONFIM;450;STC;CORTE;2022-08-09;13;13;0;3;N
GRACA;134;EPS;BAIXA;2022-08-22;18;10;8;2;N
GRACA;132;STC;RECORTE;2022-08-11;17;16;1;5;N
JACOBINA;260;EPS;RECORTE;2022-08-11;5;5;0;5;N
PAULO AFONSO;340;STC;RECORTE;2022-08-12;11;6;5;6;N
PIRAJA;353;STC;CORTE;2022-08-24;33;33;0;4;S
CONCEICAO DO COITE;65;STC;CORTE;2022-08-25;11;11;0;5;N
POSTO DA MATA;387;EPS;CORTE;2022-08-22;1;1;0;2;N
GUANAMBI;149;EPS;CORTE;2022-08-18;6;6;0;5;N
IRECE;207;EPS;CORTE;2022-08-16;10;9;1;3;N
SANTA MARIA DA VITORIA;417;EPS;RECORTE;2022-08-03;1;1;0;4;N
SANTO AMARO;424;EPS;CORTE;2022-08-09;22;20;2;3;N
SANTO AMARO;425;EPS;BAIXA;2022-08-19;16;0;16;6;S
IRECE;203;EPS;CORTE;2022-08-15;13;13;0;2;N
SANTO AMARO;420;EPS;CORTE;2022-08-08;15;15;0;2;N
LAURO DE FREITAS;298;EPS;DISJUNTOR;2022-08-15;17;17;0;2;N
TEIXEIRA DE FREITAS;482;EPS;RECORTE;2022-08-11;16;16;0;5;N
PERIPERI;347;EPS;DISJUNTOR;2022-08-15;42;41;1;2;N
ALAGOINHAS;2;EPS;CORTE;2022-08-08;33;30;3;2;N
GRACA;129;EPS;CORTE;2022-08-09;21;18;3;3;N
PAULO AFONSO;345;EPS;CORTE;2022-08-11;8;8;0;5;N
SANTO AMARO;424;EPS;RECORTE;2022-08-10;14;14;0;4;N
VITORIA DA CONQUISTA;500;EPS;CORTE;2022-08-08;18;18;0;2;N
SANTO AMARO;420;STC;CORTE;2022-08-22;21;21;0;2;N
ESPLANADA;83;STC;CORTE;2022-08-19;11;10;1;6;N
EUNAPOLIS;87;EPS;RECORTE;2022-08-11;4;3;1;5;N
VITORIA DA CONQUISTA;523;STC;CORTE;2022-08-15;11;11;0;2;N
EUNAPOLIS;98;STC;CORTE;2022-08-15;18;18;0;2;N
PERIPERI;349;STC;RECORTE;2022-08-23;38;35;3;3;N
JUAZEIRO;287;EPS;CORTE;2022-08-15;13;13;0;2;N
PITUBA;356;STC;CORTE;2022-08-11;38;38;0;5;N
SANTO AMARO;423;EPS;DISJUNTOR;2022-08-04;6;6;0;5;N
IBOTIRAMA;164;STC;CORTE;2022-08-15;9;9;0;2;N
ITAPETINGA;239;STC;CORTE;2022-08-08;9;8;1;2;N
SANTO AMARO;422;EPS;DISJUNTOR;2022-08-16;9;9;0;3;N
ITABERABA;220;STC;CORTE;2022-08-12;11;10;1;6;N
PORTO SEGURO;373;EPS;RECORTE;2022-08-24;16;16;0;4;N
IRECE;207;EPS;RECORTE;2022-08-17;5;5;0;4;N
TEIXEIRA DE FREITAS;469;STC;RECORTE;2022-08-09;17;9;8;3;N
FEIRA DE SANTANA NORTE;106;EPS;BAIXA;2022-08-24;4;4;0;4;N
ITABUNA;227;EPS;RECORTE;2022-08-04;20;19;1;5;N
BARREIRAS;17;EPS;BAIXA;2022-08-17;4;3;1;4;N
SENHOR DO BONFIM;449;STC;RECORTE;2022-08-22;11;9;2;2;N
SERRINHA;459;STC;CORTE;2022-08-11;11;10;1;5;N
ESPLANADA;77;EPS;BAIXA;2022-08-04;6;6;0;5;N
LUIS EDUARDO MAGALHAES;320;EPS;CORTE;2022-08-04;7;7;0;5;N
JUAZEIRO;288;EPS;CORTE;2022-08-03;7;7;0;4;N
PITUBA;356;STC;CORTE;2022-08-09;4;4;0;3;S
JUAZEIRO;289;STC;CORTE;2022-08-05;9;0;9;6;N
TEIXEIRA DE FREITAS;481;EPS;DISJUNTOR;2022-08-05;16;0;16;6;N
PITUBA;358;EPS;DISJUNTOR;2022-08-05;12;0;12;6;N
ESPLANADA;83;EPS;CORTE;2022-08-05;7;0;7;6;N
PIRAJA;353;STC;RECORTE;2022-08-25;20;6;14;5;S
EUNAPOLIS;87;STC;RECORTE;2022-08-25;1;1;0;5;N
GRACA;130;EPS;BAIXA;2022-08-19;19;0;19;6;S
ILHEUS;183;STC;CORTE;2022-08-16;19;19;0;3;N
GUANAMBI;142;STC;CORTE;2022-08-18;21;20;1;5;N
JUAZEIRO;284;STC;CORTE;2022-08-16;5;5;0;3;N
LUIS EDUARDO MAGALHAES;319;EPS;RECORTE;2022-08-17;5;5;0;4;N
IRECE;201;STC;CORTE;2022-08-04;9;9;0;5;N
ITAPOAN;253;EPS;CORTE;2022-08-15;18;18;0;2;N
ESPLANADA;78;EPS;CORTE;2022-08-16;14;14;0;3;N
BRUMADO;46;STC;CORTE;2022-08-15;11;10;1;2;N
TEIXEIRA DE FREITAS;474;EPS;CORTE;2022-08-08;14;12;2;2;N
ESPLANADA;79;STC;CORTE;2022-08-18;13;13;0;5;N
SANTA MARIA DA VITORIA;418;EPS;CORTE;2022-08-15;7;6;1;2;N
CONCEICAO DO COITE;63;EPS;CORTE;2022-08-12;7;6;1;6;N
CONCEICAO DO COITE;65;STC;CORTE;2022-08-02;11;11;0;3;N
SENHOR DO BONFIM;446;STC;RECORTE;2022-08-09;11;11;0;3;N
RIBEIRA DO POMBAL;408;EPS;CORTE;2022-08-08;13;12;1;2;N
IRECE;207;EPS;BAIXA;2022-08-17;6;6;0;4;N
IPIAU;526;EPS;CORTE;2022-08-18;8;8;0;5;N
ITABUNA;234;EPS;BAIXA;2022-08-17;8;8;0;4;N
ITABUNA;234;STC;CORTE;2022-08-05;20;20;0;6;S
IRECE;200;STC;CORTE;2022-08-16;10;8;2;3;N
ITAPETINGA;248;EPS;CORTE;2022-08-09;15;14;1;3;N
SANTO ANTONIO DE JESUS;428;STC;RECORTE;2022-08-19;6;1;5;6;S
VITORIA DA CONQUISTA;500;STC;RECORTE;2022-08-23;17;14;3;3;N
BOM JESUS DA LAPA;30;EPS;CORTE;2022-08-23;4;4;0;3;N
EUNAPOLIS;92;EPS;CORTE;2022-08-24;21;20;1;4;N
SERRINHA;467;EPS;CORTE;2022-08-24;6;6;0;4;N
PAULO AFONSO;340;EPS;CORTE;2022-08-22;6;6;0;2;N
CANDEIAS;59;EPS;BAIXA;2022-08-17;1;1;0;4;N
CONCEICAO DO COITE;63;STC;CORTE;2022-08-24;6;6;0;4;S
LUIS EDUARDO MAGALHAES;317;STC;CORTE;2022-08-05;11;0;11;6;N
CANDEIAS;58;EPS;CORTE;2022-08-05;48;0;48;6;N
REMANSO;390;EPS;CORTE;2022-08-05;9;0;9;6;N
VALENCA;490;EPS;CORTE;2022-08-25;22;0;22;5;N
SENHOR DO BONFIM;451;STC;CORTE;2022-08-22;11;10;1;2;N
LAURO DE FREITAS;294;EPS;CORTE;2022-08-08;24;23;1;2;N
ESPLANADA;78;EPS;RECORTE;2022-08-17;20;20;0;4;N
JEQUIE;266;EPS;CORTE;2022-08-16;21;20;1;3;N
CAMACARI;56;EPS;CORTE;2022-08-08;25;23;2;2;N
PORTO SEGURO;370;EPS;BAIXA;2022-08-11;11;10;1;5;N
VITORIA DA CONQUISTA;521;EPS;CORTE;2022-08-02;15;13;2;3;N
BRUMADO;43;STC;CORTE;2022-08-02;11;11;0;3;N
GUANAMBI;153;STC;CORTE;2022-08-09;11;10;1;3;N
BOM JESUS DA LAPA;28;STC;CORTE;2022-08-12;11;11;0;6;N
AMARGOSA;12;EPS;CORTE;2022-08-23;5;5;0;3;N
BRUMADO;41;EPS;CORTE;2022-08-12;8;8;0;6;N
IRECE;210;STC;CORTE;2022-08-19;21;21;0;6;N
GRACA;134;EPS;CORTE;2022-08-23;43;42;1;3;N
FEIRA DE SANTANA NORTE;112;EPS;CORTE;2022-08-02;24;24;0;3;N
TEIXEIRA DE FREITAS;471;STC;CORTE;2022-08-09;17;17;0;3;N
ITAPOAN;250;STC;CORTE;2022-08-16;19;16;3;3;N
SEABRA;439;EPS;CORTE;2022-08-19;11;11;0;6;N
VITORIA DA CONQUISTA;522;STC;CORTE;2022-08-04;11;11;0;5;N
SANTO ANTONIO DE JESUS;434;EPS;CORTE;2022-08-08;12;11;1;2;N
VITORIA DA CONQUISTA;507;STC;CORTE;2022-08-12;11;11;0;6;N
CONCEICAO DO COITE;62;EPS;RECORTE;2022-08-25;6;4;2;5;N
ITAPETINGA;244;EPS;CORTE;2022-08-08;15;13;2;2;N
BRUMADO;44;EPS;DISJUNTOR;2022-08-08;5;5;0;2;N
IBOTIRAMA;162;EPS;CORTE;2022-08-02;3;3;0;3;N
IRECE;200;STC;RECORTE;2022-08-17;4;4;0;4;N
ITABUNA;233;STC;RECORTE;2022-08-18;10;4;6;5;S
FEIRA DE SANTANA NORTE;113;STC;CORTE;2022-08-04;1;1;0;5;N
ITABERABA;217;EPS;CORTE;2022-08-11;5;5;0;5;N
SERRINHA;456;EPS;CORTE;2022-08-10;10;10;0;4;N
TEIXEIRA DE FREITAS;474;STC;RECORTE;2022-08-23;17;15;2;3;N
TEIXEIRA DE FREITAS;469;EPS;CORTE;2022-08-19;10;10;0;6;N
CONCEICAO DO COITE;63;STC;RECORTE;2022-08-25;10;5;5;5;S
ITAPOAN;252;EPS;RECORTE;2022-08-26;126;0;126;6;S
PITUBA;356;EPS;CORTE;2022-08-22;51;51;0;2;N
ITABERABA;219;STC;RECORTE;2022-08-02;10;9;1;3;N
BOM JESUS DA LAPA;23;STC;CORTE;2022-08-23;16;15;1;3;N
CAMACARI;55;EPS;DISJUNTOR;2022-08-03;4;3;1;4;N
VALENCA;490;EPS;CORTE;2022-08-02;20;20;0;3;N
JACOBINA;262;STC;CORTE;2022-08-02;16;15;1;3;N
GRACA;130;EPS;CORTE;2022-08-22;63;63;0;2;N
IRECE;197;EPS;CORTE;2022-08-15;13;13;0;2;N
VITORIA DA CONQUISTA;519;EPS;DISJUNTOR;2022-08-09;46;42;4;3;N
FEIRA DE SANTANA NORTE;112;EPS;RECORTE;2022-08-03;18;18;0;4;N
CAMACARI;55;EPS;RECORTE;2022-08-19;16;14;2;6;S
SANTO AMARO;422;STC;CORTE;2022-08-23;21;20;1;3;N
VITORIA DA CONQUISTA;502;STC;CORTE;2022-08-23;11;11;0;3;N
ITABERABA;214;STC;CORTE;2022-08-12;11;11;0;6;N
SERRINHA;456;EPS;RECORTE;2022-08-11;7;7;0;5;N
JACOBINA;260;EPS;CORTE;2022-08-12;7;7;0;6;N
BOM JESUS DA LAPA;24;STC;CORTE;2022-08-11;11;11;0;5;N
FEIRA DE SANTANA NORTE;108;STC;CORTE;2022-08-15;21;21;0;2;N
VITORIA DA CONQUISTA;517;STC;CORTE;2022-08-15;11;11;0;2;N
CAMACARI;53;STC;CORTE;2022-08-09;16;16;0;3;N
ITAPOAN;254;EPS;BAIXA;2022-08-04;26;23;3;5;N
ESPLANADA;78;EPS;BAIXA;2022-08-17;6;6;0;4;N
ITAPETINGA;241;STC;CORTE;2022-08-09;9;9;0;3;N
FEIRA DE SANTANA NORTE;112;STC;RECORTE;2022-08-17;15;13;2;4;N
VITORIA DA CONQUISTA;521;STC;RECORTE;2022-08-17;11;6;5;4;N
JACOBINA;259;EPS;CORTE;2022-08-24;8;8;0;4;N
LAURO DE FREITAS;295;STC;RECORTE;2022-08-09;10;3;7;3;S
IBOTIRAMA;158;STC;CORTE;2022-08-15;8;8;0;2;N
SANTO ANTONIO DE JESUS;431;STC;CORTE;2022-08-09;13;12;1;3;N
BRUMADO;37;STC;CORTE;2022-08-25;6;5;1;5;N
TEIXEIRA DE FREITAS;479;EPS;CORTE;2022-08-22;10;10;0;2;N
PITUBA;359;EPS;DISJUNTOR;2022-08-18;4;4;0;5;N
PAULO AFONSO;341;EPS;BAIXA;2022-08-11;16;16;0;5;N
ITABUNA;226;STC;CORTE;2022-08-05;16;0;16;6;N
ESPLANADA;77;EPS;CORTE;2022-08-05;17;0;17;6;N
JACOBINA;255;EPS;CORTE;2022-08-23;8;8;0;3;N
FEIRA DE SANTANA SUL;123;EPS;CORTE;2022-08-08;72;70;2;2;N
ITABUNA;236;STC;CORTE;2022-08-08;34;34;0;2;N
GUANAMBI;139;EPS;RECORTE;2022-08-18;13;13;0;5;N
POSTO DA MATA;378;EPS;RECORTE;2022-08-10;8;6;2;4;N
ILHEUS;178;STC;CORTE;2022-08-04;21;19;2;5;N
LUIS EDUARDO MAGALHAES;318;STC;CORTE;2022-08-18;21;21;0;5;N
PIRAJA;354;EPS;CORTE;2022-08-02;46;45;1;3;N
AMARGOSA;11;EPS;CORTE;2022-08-12;24;24;0;6;N
FEIRA DE SANTANA NORTE;117;EPS;CORTE;2022-08-16;23;23;0;3;N
PERIPERI;348;EPS;CORTE;2022-08-22;22;22;0;2;N
REMANSO;393;STC;CORTE;2022-08-08;9;9;0;2;N
BOM JESUS DA LAPA;33;EPS;CORTE;2022-08-12;5;4;1;6;N
ILHEUS;177;EPS;CORTE;2022-08-02;14;14;0;3;N
VALENCA;489;EPS;RECORTE;2022-08-15;10;6;4;2;N
BARREIRAS;14;STC;CORTE;2022-08-19;20;19;1;6;N
REMANSO;391;EPS;CORTE;2022-08-18;20;19;1;5;N
EUNAPOLIS;87;EPS;CORTE;2022-08-12;6;6;0;6;N
PORTO SEGURO;360;EPS;CORTE;2022-08-09;8;8;0;3;N
IBOTIRAMA;155;STC;CORTE;2022-08-02;9;9;0;3;N
ITAPOAN;252;EPS;RECORTE;2022-08-05;10;9;1;6;N
SEABRA;442;EPS;RECORTE;2022-08-10;3;3;0;4;N
JACOBINA;259;EPS;RECORTE;2022-08-25;8;6;2;5;N
VALENCA;490;EPS;RECORTE;2022-08-03;11;11;0;4;N
RIBEIRA DO POMBAL;410;STC;CORTE;2022-08-23;11;11;0;3;N
SENHOR DO BONFIM;450;STC;CORTE;2022-08-09;4;4;0;3;S
VITORIA DA CONQUISTA;519;EPS;BAIXA;2022-08-25;17;16;1;5;S
SENHOR DO BONFIM;449;EPS;CORTE;2022-08-09;6;6;0;3;N
CAMACARI;52;STC;RECORTE;2022-08-22;13;12;1;2;N
ITAPETINGA;249;EPS;CORTE;2022-08-22;2;2;0;2;N
SENHOR DO BONFIM;450;STC;CORTE;2022-08-11;13;13;0;5;N
VALENCA;491;STC;RECORTE;2022-08-05;17;0;17;6;N
PITUBA;357;STC;RECORTE;2022-08-25;21;13;8;5;N
ALAGOINHAS;4;STC;RECORTE;2022-08-24;2;2;0;4;N
JEQUIE;269;STC;CORTE;2022-08-19;11;11;0;6;N
ESPLANADA;82;EPS;CORTE;2022-08-19;12;11;1;6;N
CONCEICAO DO COITE;75;EPS;CORTE;2022-08-16;7;7;0;3;N
LAURO DE FREITAS;298;EPS;DISJUNTOR;2022-08-17;34;32;2;4;N
SENHOR DO BONFIM;445;STC;CORTE;2022-08-22;10;9;1;2;N
ITABERABA;219;EPS;CORTE;2022-08-12;5;5;0;6;N
JUAZEIRO;287;EPS;CORTE;2022-08-17;9;9;0;4;N
ILHEUS;173;STC;CORTE;2022-08-15;21;20;1;2;N
SANTO AMARO;421;STC;CORTE;2022-08-12;9;9;0;6;N
IRECE;204;STC;CORTE;2022-08-19;21;21;0;6;N
LAURO DE FREITAS;296;EPS;CORTE;2022-08-09;18;16;2;3;N
PAULO AFONSO;331;STC;CORTE;2022-08-23;16;14;2;3;N
PAULO AFONSO;332;STC;CORTE;2022-08-11;12;12;0;5;N
LAURO DE FREITAS;297;STC;CORTE;2022-08-11;16;16;0;5;N
LAURO DE FREITAS;296;STC;CORTE;2022-08-23;16;16;0;3;N
PITUBA;359;EPS;RECORTE;2022-08-11;50;24;26;5;S
AMARGOSA;6;EPS;CORTE;2022-08-23;5;5;0;3;N
SANTO ANTONIO DE JESUS;9;EPS;RECORTE;2022-08-10;6;5;1;4;N
SANTO AMARO;419;EPS;CORTE;2022-08-22;12;12;0;2;N
SANTO ANTONIO DE JESUS;428;EPS;CORTE;2022-08-08;12;12;0;2;N
VALENCA;495;EPS;CORTE;2022-08-16;21;21;0;3;N
JUAZEIRO;288;STC;CORTE;2022-08-19;9;9;0;6;N
GRACA;131;EPS;BAIXA;2022-08-11;20;15;5;5;N
BOM JESUS DA LAPA;23;EPS;BAIXA;2022-08-10;4;4;0;4;N
SANTO AMARO;421;EPS;BAIXA;2022-08-22;10;10;0;2;N
SENHOR DO BONFIM;445;EPS;CORTE;2022-08-08;7;6;1;2;N
ITABUNA;225;EPS;BAIXA;2022-08-04;5;5;0;5;N
IRECE;198;EPS;BAIXA;2022-08-04;7;7;0;5;N
SENHOR DO BONFIM;449;EPS;RECORTE;2022-08-10;6;5;1;4;N
PORTO SEGURO;370;EPS;CORTE;2022-08-12;9;9;0;6;N
PERIPERI;349;STC;RECORTE;2022-08-23;10;1;9;3;S
CONCEICAO DO COITE;68;EPS;BAIXA;2022-08-25;15;13;2;5;S
CANDEIAS;533;EPS;DISJUNTOR;2022-08-02;10;10;0;3;N
ITABUNA;184;STC;RECORTE;2022-08-18;7;4;3;5;S
RIBEIRA DO POMBAL;410;STC;RECORTE;2022-08-24;4;4;0;4;N
VITORIA DA CONQUISTA;508;STC;CORTE;2022-08-25;11;11;0;5;N
POSTO DA MATA;383;EPS;CORTE;2022-08-23;8;8;0;3;N
ITAPETINGA;238;EPS;CORTE;2022-08-08;15;8;7;2;N
ILHEUS;187;EPS;CORTE;2022-08-05;7;7;0;6;N
VITORIA DA CONQUISTA;524;STC;CORTE;2022-08-05;11;0;11;6;N
JUAZEIRO;288;EPS;CORTE;2022-08-05;6;0;6;6;N
IRECE;204;EPS;CORTE;2022-08-05;10;0;10;6;N
ALAGOINHAS;4;EPS;BAIXA;2022-08-10;2;0;2;4;N
IBOTIRAMA;160;STC;CORTE;2022-08-16;9;9;0;3;N
IRECE;199;EPS;CORTE;2022-08-16;10;9;1;3;N
SEABRA;443;EPS;CORTE;2022-08-22;10;10;0;2;N
BARREIRAS;21;STC;CORTE;2022-08-09;15;15;0;3;N
VITORIA DA CONQUISTA;520;EPS;DISJUNTOR;2022-08-22;28;27;1;2;N
PITUBA;357;STC;RECORTE;2022-08-02;63;55;8;3;N
FEIRA DE SANTANA NORTE;106;EPS;RECORTE;2022-08-03;14;14;0;4;N
BRUMADO;49;EPS;RECORTE;2022-08-17;3;3;0;4;N
JUAZEIRO;284;STC;CORTE;2022-08-18;9;9;0;5;N
PAULO AFONSO;341;EPS;CORTE;2022-08-12;8;8;0;6;N
PORTO SEGURO;366;EPS;CORTE;2022-08-11;7;7;0;5;N
VITORIA DA CONQUISTA;500;EPS;RECORTE;2022-08-11;15;15;0;5;N
FEIRA DE SANTANA SUL;128;EPS;CORTE;2022-08-22;18;18;0;2;N
JEQUIE;279;STC;CORTE;2022-08-22;11;11;0;2;N
VALENCA;491;EPS;CORTE;2022-08-15;14;14;0;2;N
IRECE;200;STC;CORTE;2022-08-18;8;8;0;5;N
ALAGOINHAS;2;STC;RECORTE;2022-08-23;7;6;1;3;S
AMARGOSA;6;EPS;RECORTE;2022-08-24;25;24;1;4;N
VALENCA;495;EPS;RECORTE;2022-08-17;7;7;0;4;N
ESPLANADA;78;EPS;CORTE;2022-08-18;13;12;1;5;N
RIBEIRA DO POMBAL;399;STC;RECORTE;2022-08-10;11;10;1;4;N
PAULO AFONSO;327;STC;CORTE;2022-08-22;16;16;0;2;N
SENHOR DO BONFIM;454;EPS;CORTE;2022-08-23;20;20;0;3;N
CONCEICAO DO COITE;73;EPS;DISJUNTOR;2022-08-23;5;5;0;3;N
SENHOR DO BONFIM;445;STC;RECORTE;2022-08-23;11;9;2;3;N
PIRAJA;352;EPS;BAIXA;2022-08-25;15;10;5;5;S
PAULO AFONSO;346;STC;RECORTE;2022-08-16;11;7;4;3;N
CONCEICAO DO COITE;68;EPS;RECORTE;2022-08-04;6;3;3;5;N
ITABERABA;215;STC;CORTE;2022-08-25;21;21;0;5;N
ILHEUS;182;EPS;CORTE;2022-08-16;23;22;1;3;N
ILHEUS;183;EPS;CORTE;2022-08-04;12;0;12;5;N
IRECE;205;STC;RECORTE;2022-08-08;16;16;0;2;N
BRUMADO;47;STC;CORTE;2022-08-05;11;0;11;6;N
PAULO AFONSO;407;EPS;CORTE;2022-08-05;8;0;8;6;N
ITAPOAN;254;EPS;CORTE;2022-08-05;23;0;23;6;N
ITAPOAN;252;EPS;DISJUNTOR;2022-08-12;28;28;0;6;N
ITAPOAN;253;EPS;RECORTE;2022-08-18;39;39;0;5;N
ITABUNA;230;STC;CORTE;2022-08-08;16;13;3;2;N
TEIXEIRA DE FREITAS;470;EPS;CORTE;2022-08-09;11;11;0;3;N
SENHOR DO BONFIM;450;EPS;CORTE;2022-08-22;20;20;0;2;N
IRECE;199;EPS;RECORTE;2022-08-17;5;4;1;4;N
SANTO ANTONIO DE JESUS;433;EPS;CORTE;2022-08-22;4;4;0;2;N
PAULO AFONSO;402;EPS;CORTE;2022-08-16;8;8;0;3;N
GUANAMBI;138;STC;CORTE;2022-08-19;21;20;1;6;N
BOM JESUS DA LAPA;29;STC;CORTE;2022-08-02;6;6;0;3;N
PAULO AFONSO;403;STC;CORTE;2022-08-18;11;11;0;5;N
GUANAMBI;152;STC;CORTE;2022-08-23;21;20;1;3;N
IPIAU;188;STC;CORTE;2022-08-19;19;19;0;6;N
SEABRA;441;STC;CORTE;2022-08-11;11;9;2;5;N
TEIXEIRA DE FREITAS;471;STC;CORTE;2022-08-11;17;16;1;5;N
SENHOR DO BONFIM;454;EPS;RECORTE;2022-08-24;11;11;0;4;N
ITABUNA;228;EPS;CORTE;2022-08-18;15;13;2;5;N
AMARGOSA;6;EPS;BAIXA;2022-08-24;2;1;1;4;N
BRUMADO;42;STC;CORTE;2022-08-16;11;11;0;3;N
ITAPOAN;254;STC;RECORTE;2022-08-18;9;6;3;5;S
SANTA MARIA DA VITORIA;414;EPS;CORTE;2022-08-16;7;7;0;3;N
IRECE;200;STC;RECORTE;2022-08-17;10;9;1;4;S
SANTA MARIA DA VITORIA;415;STC;CORTE;2022-08-18;8;8;0;5;N
SEABRA;440;EPS;CORTE;2022-08-09;5;5;0;3;N
IRECE;211;STC;CORTE;2022-08-09;11;10;1;3;N
PAULO AFONSO;330;EPS;BAIXA;2022-08-22;11;0;11;2;N
FEIRA DE SANTANA NORTE;107;EPS;CORTE;2022-08-15;61;59;2;2;N
JEQUIE;277;EPS;CORTE;2022-08-09;22;20;2;3;N
RIBEIRA DO POMBAL;400;EPS;CORTE;2022-08-08;14;14;0;2;N
CAMACARI;52;EPS;CORTE;2022-08-09;18;17;1;3;N
ALAGOINHAS;4;EPS;CORTE;2022-08-11;19;16;3;5;N
JACOBINA;262;STC;CORTE;2022-08-02;7;6;1;3;S
ALAGOINHAS;3;EPS;CORTE;2022-08-23;10;10;0;3;N
SERRINHA;467;EPS;CORTE;2022-08-03;5;5;0;4;N
GRACA;133;STC;CORTE;2022-08-02;34;32;2;3;N
PITUBA;357;EPS;CORTE;2022-08-12;19;17;2;6;N
GRACA;131;EPS;CORTE;2022-08-12;21;20;1;6;N
SANTO ANTONIO DE JESUS;430;STC;CORTE;2022-08-23;13;12;1;3;N
PAULO AFONSO;325;EPS;CORTE;2022-08-09;8;6;2;3;N
SANTA MARIA DA VITORIA;411;STC;CORTE;2022-08-17;3;3;0;4;N
SANTO ANTONIO DE JESUS;434;STC;DISJUNTOR;2022-08-05;20;20;0;6;S
TEIXEIRA DE FREITAS;485;STC;RECORTE;2022-08-16;34;30;4;3;N
GRACA;136;STC;RECORTE;2022-08-16;17;17;0;3;N
VITORIA DA CONQUISTA;516;EPS;CORTE;2022-08-15;13;13;0;2;N
ITAPETINGA;241;STC;CORTE;2022-08-11;9;9;0;5;N
SANTA MARIA DA VITORIA;414;EPS;RECORTE;2022-08-17;5;5;0;4;N
FEIRA DE SANTANA NORTE;111;EPS;RECORTE;2022-08-17;6;4;2;4;N
FEIRA DE SANTANA NORTE;112;STC;RECORTE;2022-08-19;21;19;2;6;N
IPIAU;532;EPS;CORTE;2022-08-22;7;6;1;2;N
BRUMADO;46;EPS;BAIXA;2022-08-04;4;4;0;5;N
IRECE;199;EPS;BAIXA;2022-08-17;5;5;0;4;N
POSTO DA MATA;378;EPS;CORTE;2022-08-11;7;7;0;5;N
JACOBINA;262;STC;CORTE;2022-08-04;16;16;0;5;N
JACOBINA;261;EPS;CORTE;2022-08-02;9;8;1;3;N
LUIS EDUARDO MAGALHAES;323;STC;CORTE;2022-08-09;11;10;1;3;N
LIVRAMENTO DE NOSSA SENHORA;306;STC;RECORTE;2022-08-03;5;4;1;4;N
SANTO ANTONIO DE JESUS;431;STC;CORTE;2022-08-11;13;13;0;5;N
FEIRA DE SANTANA NORTE;113;STC;RECORTE;2022-08-05;6;1;5;6;S
TEIXEIRA DE FREITAS;471;STC;RECORTE;2022-08-12;17;14;3;6;N
VITORIA DA CONQUISTA;521;EPS;RECORTE;2022-08-05;31;30;1;6;N
GRACA;132;STC;CORTE;2022-08-12;12;12;0;6;S
SANTO AMARO;422;STC;CORTE;2022-08-25;21;21;0;5;N
VITORIA DA CONQUISTA;502;STC;CORTE;2022-08-25;11;11;0;5;N
LUIS EDUARDO MAGALHAES;321;EPS;CORTE;2022-08-19;6;6;0;6;N
BOM JESUS DA LAPA;23;EPS;CORTE;2022-08-11;10;10;0;5;N
ITABERABA;213;EPS;CORTE;2022-08-12;5;5;0;6;N
SANTA MARIA DA VITORIA;412;STC;CORTE;2022-08-05;11;0;11;6;N
VITORIA DA CONQUISTA;518;STC;CORTE;2022-08-05;11;0;11;6;N
ITABUNA;225;EPS;CORTE;2022-08-05;7;0;7;6;N
SERRINHA;464;STC;CORTE;2022-08-04;11;10;1;5;N
IRECE;193;EPS;CORTE;2022-08-16;30;28;2;3;N
SENHOR DO BONFIM;449;EPS;CORTE;2022-08-11;6;6;0;5;N
TEIXEIRA DE FREITAS;469;EPS;BAIXA;2022-08-22;15;15;0;2;N
CONCEICAO DO COITE;66;EPS;CORTE;2022-08-03;3;2;1;4;N
LUIS EDUARDO MAGALHAES;319;STC;CORTE;2022-08-08;6;6;0;2;N
FEIRA DE SANTANA SUL;123;EPS;CORTE;2022-08-10;54;51;3;4;N
JUAZEIRO;292;EPS;CORTE;2022-08-08;20;17;3;2;N
CAMACARI;50;EPS;DISJUNTOR;2022-08-16;30;29;1;3;N
CANDEIAS;533;EPS;CORTE;2022-08-19;38;38;0;6;S
ALAGOINHAS;3;EPS;RECORTE;2022-08-24;57;53;4;4;N
PIRAJA;353;EPS;CORTE;2022-08-16;15;14;1;3;N
PIRAJA;354;EPS;CORTE;2022-08-04;14;14;0;5;N
IPIAU;530;STC;CORTE;2022-08-11;13;12;1;5;N
SERRINHA;463;EPS;CORTE;2022-08-02;5;5;0;3;N
PERIPERI;349;EPS;CORTE;2022-08-12;15;15;0;6;N
SENHOR DO BONFIM;448;EPS;CORTE;2022-08-23;10;10;0;3;N
CAMACARI;52;EPS;RECORTE;2022-08-10;15;14;1;4;N
LIVRAMENTO DE NOSSA SENHORA;311;EPS;CORTE;2022-08-02;6;6;0;3;N
LIVRAMENTO DE NOSSA SENHORA;312;STC;CORTE;2022-08-04;4;4;0;5;N
IRECE;194;EPS;CORTE;2022-08-04;8;8;0;5;N
LUIS EDUARDO MAGALHAES;317;EPS;CORTE;2022-08-18;7;3;4;5;N
EUNAPOLIS;88;EPS;CORTE;2022-08-02;12;11;1;3;N
JEQUIE;273;STC;CORTE;2022-08-22;11;11;0;2;N
CONCEICAO DO COITE;65;EPS;CORTE;2022-08-15;7;6;1;2;N
REMANSO;392;EPS;CORTE;2022-08-08;29;23;6;2;N
FEIRA DE SANTANA NORTE;109;STC;RECORTE;2022-08-04;30;20;10;5;S
FEIRA DE SANTANA NORTE;108;STC;RECORTE;2022-08-16;15;8;7;3;S
AMARGOSA;12;EPS;CORTE;2022-08-02;7;7;0;3;N
RIBEIRA DO POMBAL;409;EPS;CORTE;2022-08-23;9;8;1;3;N
PORTO SEGURO;360;EPS;CORTE;2022-08-11;9;9;0;5;N
VALENCA;489;EPS;RECORTE;2022-08-15;7;7;0;2;S
ITABERABA;213;STC;RECORTE;2022-08-25;4;2;2;5;S
CANDEIAS;58;EPS;DISJUNTOR;2022-08-15;16;16;0;2;N
ITABUNA;232;STC;CORTE;2022-08-09;16;16;0;3;N
EUNAPOLIS;88;EPS;RECORTE;2022-08-03;5;4;1;4;N
LAURO DE FREITAS;295;EPS;CORTE;2022-08-23;14;11;3;3;N
SERRINHA;459;STC;CORTE;2022-08-15;11;11;0;2;N
SANTO AMARO;422;STC;CORTE;2022-08-02;9;8;1;3;N
FEIRA DE SANTANA SUL;123;EPS;RECORTE;2022-08-11;40;37;3;5;N
SANTO AMARO;421;STC;CORTE;2022-08-12;44;44;0;6;S
REMANSO;389;STC;CORTE;2022-08-09;9;9;0;3;N
ESPLANADA;83;EPS;CORTE;2022-08-09;15;12;3;3;N
PORTO SEGURO;371;EPS;CORTE;2022-08-02;8;6;2;3;N
IRECE;193;EPS;RECORTE;2022-08-17;15;15;0;4;N
BRUMADO;36;EPS;CORTE;2022-08-02;6;6;0;3;N
SANTO AMARO;420;EPS;CORTE;2022-08-12;11;10;1;6;N
GRACA;136;EPS;CORTE;2022-08-24;10;10;0;4;S
PERIPERI;347;EPS;DISJUNTOR;2022-08-19;62;58;4;6;N
JUAZEIRO;287;EPS;CORTE;2022-08-19;10;9;1;6;N
VALENCA;495;EPS;CORTE;2022-08-18;21;21;0;5;N
CONCEICAO DO COITE;64;EPS;DISJUNTOR;2022-08-10;3;2;1;4;N
BRUMADO;37;STC;CORTE;2022-08-04;11;11;0;5;N
EUNAPOLIS;97;EPS;CORTE;2022-08-17;6;5;1;4;N
ALAGOINHAS;3;EPS;BAIXA;2022-08-24;7;6;1;4;N
IRECE;203;EPS;CORTE;2022-08-19;16;13;3;6;N
LIVRAMENTO DE NOSSA SENHORA;311;EPS;RECORTE;2022-08-03;3;2;1;4;N
ITABERABA;220;STC;CORTE;2022-08-16;10;10;0;3;N
IBOTIRAMA;169;STC;RECORTE;2022-08-09;11;8;3;3;N
FEIRA DE SANTANA NORTE;113;EPS;CORTE;2022-08-17;24;23;1;4;N
CAMACARI;52;EPS;BAIXA;2022-08-10;5;4;1;4;N
LAURO DE FREITAS;296;STC;CORTE;2022-08-25;16;15;1;5;N
RIBEIRA DO POMBAL;405;EPS;CORTE;2022-08-22;6;6;0;2;N
ILHEUS;186;EPS;CORTE;2022-08-19;12;12;0;6;N
JEQUIE;270;STC;CORTE;2022-08-09;11;11;0;3;N
SERRINHA;464;STC;RECORTE;2022-08-05;9;0;9;6;N
VITORIA DA CONQUISTA;523;EPS;CORTE;2022-08-05;19;0;19;6;N
LIVRAMENTO DE NOSSA SENHORA;305;EPS;CORTE;2022-08-25;5;0;5;5;N
BOM JESUS DA LAPA;28;EPS;CORTE;2022-08-25;4;0;4;5;N
AMARGOSA;5;STC;CORTE;2022-08-02;20;20;0;3;N
IRECE;201;STC;CORTE;2022-08-08;7;7;0;2;N
ESPLANADA;79;STC;CORTE;2022-08-22;26;25;1;2;N
BARREIRAS;20;EPS;CORTE;2022-08-09;8;8;0;3;N
SERRINHA;468;EPS;CORTE;2022-08-16;7;6;1;3;N
BARREIRAS;20;STC;CORTE;2022-08-23;42;41;1;3;N
JACOBINA;262;EPS;CORTE;2022-08-15;9;9;0;2;N
GUANAMBI;142;EPS;CORTE;2022-08-08;7;7;0;2;N
PAULO AFONSO;328;STC;CORTE;2022-08-12;11;11;0;6;N
LAURO DE FREITAS;293;STC;CORTE;2022-08-12;16;16;0;6;N
ESPLANADA;83;EPS;RECORTE;2022-08-10;7;7;0;4;N
IBOTIRAMA;163;EPS;RECORTE;2022-08-18;5;5;0;5;N
GUANAMBI;142;STC;CORTE;2022-08-22;21;21;0;2;N
JUAZEIRO;285;STC;CORTE;2022-08-08;9;9;0;2;N
ITABERABA;216;STC;CORTE;2022-08-15;11;10;1;2;N
EUNAPOLIS;97;EPS;RECORTE;2022-08-18;3;3;0;5;N
LIVRAMENTO DE NOSSA SENHORA;309;EPS;BAIXA;2022-08-25;9;7;2;5;S
IRECE;193;EPS;BAIXA;2022-08-17;6;4;2;4;N
BRUMADO;47;EPS;BAIXA;2022-08-17;4;4;0;4;N
CONCEICAO DO COITE;72;STC;CORTE;2022-08-19;11;8;3;6;N
ITABERABA;220;STC;RECORTE;2022-08-17;21;21;0;4;N
VITORIA DA CONQUISTA;520;EPS;DISJUNTOR;2022-08-24;3;3;0;4;N
FEIRA DE SANTANA SUL;128;EPS;CORTE;2022-08-24;16;13;3;4;N
EUNAPOLIS;93;EPS;CORTE;2022-08-16;14;14;0;3;N
ITABERABA;215;STC;CORTE;2022-08-25;7;7;0;5;S
BARREIRAS;21;STC;CORTE;2022-08-11;15;15;0;5;N
JACOBINA;264;STC;CORTE;2022-08-05;7;0;7;6;N
VALENCA;492;EPS;CORTE;2022-08-05;14;0;14;6;N
CANDEIAS;59;EPS;BAIXA;2022-08-19;28;0;28;6;S
SENHOR DO BONFIM;454;EPS;CORTE;2022-08-25;20;0;20;5;N
SENHOR DO BONFIM;453;STC;CORTE;2022-08-02;12;12;0;3;N
PORTO SEGURO;376;EPS;CORTE;2022-08-16;18;18;0;3;N
IRECE;210;STC;CORTE;2022-08-23;16;15;1;3;N
REMANSO;394;STC;CORTE;2022-08-23;14;14;0;3;N
FEIRA DE SANTANA SUL;128;EPS;RECORTE;2022-08-25;30;18;12;5;N
ITAPOAN;253;EPS;RECORTE;2022-08-18;80;44;36;5;S
FEIRA DE SANTANA SUL;124;EPS;CORTE;2022-08-23;18;18;0;3;N
PORTO SEGURO;377;STC;CORTE;2022-08-16;20;20;0;3;S
VALENCA;490;EPS;DISJUNTOR;2022-08-12;16;16;0;6;N
SANTO ANTONIO DE JESUS;434;EPS;CORTE;2022-08-12;10;9;1;6;N
BARREIRAS;16;STC;CORTE;2022-08-22;21;21;0;2;N
ITAPETINGA;244;EPS;CORTE;2022-08-12;12;12;0;6;N
IPIAU;188;STC;CORTE;2022-08-19;18;18;0;6;S
ESPLANADA;79;STC;RECORTE;2022-08-23;21;21;0;3;N
BRUMADO;44;EPS;DISJUNTOR;2022-08-12;6;6;0;6;N
GRACA;137;STC;CORTE;2022-08-03;2;2;0;4;S
IRECE;211;STC;CORTE;2022-08-11;11;10;1;5;N
IBOTIRAMA;163;EPS;BAIXA;2022-08-18;2;2;0;5;N
SENHOR DO BONFIM;451;EPS;CORTE;2022-08-12;6;6;0;6;N
PAULO AFONSO;341;EPS;RECORTE;2022-08-15;10;8;2;2;N
RIBEIRA DO POMBAL;405;EPS;BAIXA;2022-08-23;13;12;1;3;N
ESPLANADA;83;EPS;BAIXA;2022-08-10;2;2;0;4;N
BOM JESUS DA LAPA;28;EPS;CORTE;2022-08-02;7;7;0;3;N
ITABUNA;233;EPS;RECORTE;2022-08-10;7;6;1;4;N
GRACA;136;EPS;BAIXA;2022-08-25;7;5;2;5;S
JACOBINA;534;STC;RECORTE;2022-08-03;1;1;0;4;N
PORTO SEGURO;377;EPS;CORTE;2022-08-04;8;8;0;5;N
GUANAMBI;152;STC;CORTE;2022-08-25;21;21;0;5;N
ILHEUS;173;EPS;BAIXA;2022-08-04;10;6;4;5;N
SANTA MARIA DA VITORIA;414;EPS;CORTE;2022-08-18;2;2;0;5;N
BOM JESUS DA LAPA;29;STC;CORTE;2022-08-04;5;5;0;5;N
IRECE;210;EPS;CORTE;2022-08-09;14;13;1;3;N
SEABRA;440;EPS;CORTE;2022-08-11;5;5;0;5;N
PAULO AFONSO;327;STC;RECORTE;2022-08-25;12;8;4;5;N
ILHEUS;178;STC;DISJUNTOR;2022-08-12;25;25;0;6;S
LUIS EDUARDO MAGALHAES;323;STC;CORTE;2022-08-11;11;11;0;5;N
GRACA;132;EPS;CORTE;2022-08-02;49;43;6;3;N
JACOBINA;262;EPS;BAIXA;2022-08-16;15;15;0;3;N
PITUBA;358;EPS;CORTE;2022-08-02;27;25;2;3;N
RIBEIRA DO POMBAL;399;EPS;CORTE;2022-08-22;10;9;1;2;N
SANTA MARIA DA VITORIA;414;EPS;RECORTE;2022-08-19;15;13;2;6;N
FEIRA DE SANTANA NORTE;107;EPS;CORTE;2022-08-17;40;37;3;4;N
TEIXEIRA DE FREITAS;481;STC;CORTE;2022-08-16;17;17;0;3;N
ITABERABA;214;EPS;CORTE;2022-08-02;5;5;0;3;N
TEIXEIRA DE FREITAS;481;EPS;CORTE;2022-08-02;11;9;2;3;N
PITUBA;358;STC;CORTE;2022-08-16;19;18;1;3;N
BOM JESUS DA LAPA;24;STC;CORTE;2022-08-15;10;9;1;2;N
ITABERABA;215;STC;CORTE;2022-08-04;11;11;0;5;N
PITUBA;359;EPS;DISJUNTOR;2022-08-22;34;33;1;2;N
IBOTIRAMA;157;EPS;CORTE;2022-08-17;7;7;0;4;N
JACOBINA;263;EPS;BAIXA;2022-08-04;5;5;0;5;N
ESPLANADA;84;EPS;CORTE;2022-08-22;6;6;0;2;N
RIBEIRA DO POMBAL;400;EPS;CORTE;2022-08-10;11;11;0;4;N
POSTO DA MATA;387;STC;CORTE;2022-08-16;13;12;1;3;N
PORTO SEGURO;376;EPS;RECORTE;2022-08-17;34;32;2;4;N
SANTO ANTONIO DE JESUS;430;EPS;CORTE;2022-08-11;5;4;1;5;N
BARREIRAS;20;EPS;BAIXA;2022-08-10;5;5;0;4;N
TEIXEIRA DE FREITAS;485;EPS;RECORTE;2022-08-04;18;18;0;5;N
FEIRA DE SANTANA NORTE;112;STC;RECORTE;2022-08-19;8;3;5;6;S
ITAPETINGA;240;STC;CORTE;2022-08-25;11;11;0;5;N
SENHOR DO BONFIM;447;STC;CORTE;2022-08-25;7;6;1;5;N
AMARGOSA;11;EPS;DISJUNTOR;2022-08-22;2;2;0;2;N
FEIRA DE SANTANA NORTE;108;EPS;CORTE;2022-08-05;54;0;54;6;N
VITORIA DA CONQUISTA;517;EPS;CORTE;2022-08-05;10;0;10;6;N
IBOTIRAMA;158;EPS;CORTE;2022-08-05;3;0;3;6;N
FEIRA DE SANTANA NORTE;108;STC;CORTE;2022-08-19;1;1;0;6;N
SANTO AMARO;421;EPS;CORTE;2022-08-25;15;0;15;5;N
JACOBINA;256;EPS;CORTE;2022-08-15;9;9;0;2;N
LUIS EDUARDO MAGALHAES;318;EPS;CORTE;2022-08-08;10;9;1;2;N
VALENCA;498;STC;RECORTE;2022-08-22;21;18;3;2;N
JACOBINA;257;EPS;CORTE;2022-08-03;7;7;0;4;N
IPIAU;532;STC;DISJUNTOR;2022-08-19;16;16;0;6;S
REMANSO;391;EPS;CORTE;2022-08-22;13;13;0;2;N
LIVRAMENTO DE NOSSA SENHORA;310;EPS;CORTE;2022-08-16;6;6;0;3;N
IRECE;193;EPS;CORTE;2022-08-18;16;14;2;5;N
LIVRAMENTO DE NOSSA SENHORA;311;EPS;CORTE;2022-08-04;6;6;0;5;N
IBOTIRAMA;159;STC;RECORTE;2022-08-08;11;11;0;2;N
GRACA;136;EPS;BAIXA;2022-08-04;22;20;2;5;N
ITABERABA;214;STC;RECORTE;2022-08-17;21;15;6;4;N
BOM JESUS DA LAPA;34;EPS;CORTE;2022-08-04;7;7;0;5;N
REMANSO;393;STC;CORTE;2022-08-12;9;9;0;6;N
LUIS EDUARDO MAGALHAES;318;STC;CORTE;2022-08-22;10;10;0;2;N
IBOTIRAMA;154;STC;CORTE;2022-08-18;16;16;0;5;N
SANTO ANTONIO DE JESUS;429;EPS;RECORTE;2022-08-24;8;7;1;4;N
TEIXEIRA DE FREITAS;485;EPS;BAIXA;2022-08-04;3;3;0;5;N
ALAGOINHAS;2;STC;CORTE;2022-08-02;4;4;0;3;N
SANTO AMARO;425;EPS;BAIXA;2022-08-25;15;15;0;5;S
FEIRA DE SANTANA NORTE;108;STC;RECORTE;2022-08-18;6;5;1;5;S
ITABERABA;223;EPS;CORTE;2022-08-17;4;4;0;4;N
CANDEIAS;59;EPS;CORTE;2022-08-22;8;8;0;2;N
SANTO ANTONIO DE JESUS;431;STC;RECORTE;2022-08-12;15;6;9;6;S
BOM JESUS DA LAPA;33;EPS;CORTE;2022-08-16;5;5;0;3;N
PORTO SEGURO;377;EPS;BAIXA;2022-08-05;1;1;0;6;N
PITUBA;359;STC;RECORTE;2022-08-05;21;0;21;6;N
TEIXEIRA DE FREITAS;479;EPS;DISJUNTOR;2022-08-09;1;1;0;3;N
VALENCA;486;EPS;CORTE;2022-08-05;8;0;8;6;N
